"a" = (/turf/closed/mineral/volcanic/lava_land_surface,/area/lavaland/surface/outdoors)
"b" = (/obj/effect/decal/cleanable/blood/drip,/turf/open/floor/plating/asteroid/basalt/lava_land_surface,/area/lavaland/surface/outdoors)
"c" = (/turf/closed/wall/mineral/iron,/area/ruin/powered)
"d" = (/obj/item/circuitboard/machine/circuit_imprinter,/turf/open/floor/plating/asteroid/basalt,/area/ruin/powered)
"e" = (/obj/item/clothing/mask/breath,/turf/open/floor/plating/asteroid{name = "dirt"},/area/ruin/powered)
"f" = (/turf/open/floor/plating/asteroid/basalt,/area/ruin/powered)
"g" = (/turf/open/floor/plating/asteroid{name = "dirt"},/area/ruin/powered)
"h" = (/obj/item/shovel,/turf/open/floor/plating/asteroid{name = "dirt"},/area/ruin/powered)
"i" = (/obj/item/reagent_containers/glass/bucket,/turf/open/floor/plating/asteroid{name = "dirt"},/area/ruin/powered)
"j" = (/obj/structure/sink/puddle,/turf/open/floor/plating/asteroid{name = "dirt"},/area/ruin/powered)
"k" = (/obj/machinery/hydroponics/soil,/turf/open/floor/plating/asteroid{name = "dirt"},/area/ruin/powered)
"l" = (/obj/item/storage/toolbox/emergency,/turf/open/floor/plating/asteroid{name = "dirt"},/area/ruin/powered)
"m" = (/obj/structure/glowshroom/single,/turf/open/floor/plating/asteroid{name = "dirt"},/area/ruin/powered)
"n" = (/obj/structure/rack,/obj/item/seeds/reishi,/obj/item/seeds/plump,/obj/item/seeds/plump,/obj/item/seeds/tower,/obj/item/reagent_containers/food/snacks/grown/mushroom/glowshroom,/obj/item/reagent_containers/food/snacks/grown/mushroom/glowshroom,/turf/open/floor/plating/asteroid/basalt,/area/ruin/powered)
"o" = (/turf/open/floor/plating,/area/ruin/powered)
"p" = (/obj/structure/rack,/obj/item/storage/bag/plants/portaseeder,/obj/item/storage/bag/ore,/obj/item/storage/firstaid/regular,/obj/item/clothing/mask/breath,/turf/open/floor/plating/asteroid/basalt,/area/ruin/powered)
"q" = (/obj/structure/glowshroom/single,/turf/open/floor/plating,/area/ruin/powered)
"r" = (/obj/structure/rack,/obj/item/tank/internals/oxygen,/obj/item/pickaxe/emergency,/obj/item/tank/internals/oxygen,/obj/item/pickaxe/emergency,/turf/open/floor/plating/asteroid/basalt,/area/ruin/powered)
"s" = (/turf/open/floor/plating/asteroid/basalt/lava_land_surface,/area/lavaland/surface/outdoors)
"t" = (/turf/closed/wall/mineral/titanium/survival/pod,/area/ruin/powered)
"u" = (/obj/structure/bed/pod,/obj/item/bedsheet/black,/turf/open/floor/plating,/area/ruin/powered)
"v" = (/obj/structure/fans,/turf/open/floor/pod/dark,/area/ruin/powered)
"w" = (/obj/machinery/smartfridge/survival_pod,/turf/open/floor/pod/dark,/area/ruin/powered)
"x" = (/obj/effect/mob_spawn/human/duohermit,/turf/open/floor/pod/dark,/area/ruin/powered)
"y" = (/turf/open/floor/pod/dark,/area/ruin/powered)
"z" = (/obj/machinery/light/small{dir = 4},/obj/structure/tubes,/turf/open/floor/plating,/area/ruin/powered)
"A" = (/obj/structure/table,/obj/item/clothing/head/welding,/obj/item/hatchet,/obj/item/kitchen/knife/combat/survival,/turf/open/floor/plating,/area/ruin/powered)
"C" = (/obj/structure/tubes,/obj/item/crowbar,/obj/effect/decal/cleanable/blood/drip,/turf/open/floor/pod/dark,/area/ruin/powered)
"D" = (/obj/effect/decal/cleanable/blood/footprints{dir = 1; icon_state = "blood1"},/obj/machinery/door/airlock/survival_pod/glass,/obj/structure/fans/tiny,/turf/open/floor/pod/dark,/area/ruin/powered)
"E" = (/obj/structure/chair/comfy/shuttle{dir = 4},/turf/open/floor/mineral/titanium/blue,/area/ruin/powered)
"F" = (/obj/machinery/computer{desc = "A computer long since rendered non-functional due to lack of maintenance. Spitting out error messages."; dir = 8; name = "Broken Computer"},/turf/open/floor/mineral/titanium/blue,/area/ruin/powered)
"G" = (/obj/item/clothing/suit/space/orange,/turf/open/floor/plating/asteroid{name = "dirt"},/area/ruin/powered)
"H" = (/obj/item/storage/toolbox/mechanical,/turf/open/floor/mineral/titanium/blue,/area/ruin/powered)
"I" = (/obj/item/circuitboard/machine/autolathe,/obj/item/stock_parts/matter_bin,/turf/open/floor/mineral/titanium/blue,/area/ruin/powered)
"J" = (/obj/item/stock_parts/manipulator,/turf/open/floor/plating/asteroid/basalt,/area/ruin/powered)
"K" = (/obj/structure/mirror{pixel_x = 28},/turf/open/floor/plating,/area/ruin/powered)
"L" = (/obj/item/clothing/head/helmet/space/orange,/turf/open/floor/plating/asteroid{name = "dirt"},/area/ruin/powered)
"M" = (/obj/structure/girder,/turf/open/floor/plating{initial_gas_mix = "o2=14;n2=23;TEMP=300"},/area/ruin/powered)
"N" = (/obj/effect/spawner/structure/window/shuttle,/turf/open/floor/plating{initial_gas_mix = "o2=14;n2=23;TEMP=300"},/area/ruin/powered)
"O" = (/obj/machinery/door/airlock/titanium{name = "Escape Pod Airlock"},/turf/open/floor/mineral/titanium/blue,/area/ruin/powered)
"Q" = (/turf/open/floor/mineral/titanium/blue,/area/ruin/powered)
"T" = (/obj/item/stock_parts/matter_bin,/turf/open/floor/plating/asteroid/basalt,/area/ruin/powered)
"U" = (/obj/item/stock_parts/matter_bin,/turf/open/floor/plating/asteroid/basalt/lava_land_surface,/area/lavaland/surface/outdoors)
"V" = (/turf/closed/wall/mineral/titanium/interior,/area/ruin/powered)
"W" = (/obj/structure/shuttle/engine/propulsion/burst{dir = 8},/turf/closed/wall/mineral/titanium/interior,/area/ruin/powered)
"Y" = (/obj/item/mining_scanner,/turf/open/floor/plating/asteroid/basalt,/area/ruin/powered)
"Z" = (/obj/item/circuitboard/machine/protolathe/department/science,/obj/item/circuitboard/computer/rdconsole,/turf/open/floor/plating/asteroid/basalt,/area/ruin/powered)

(1,1,1) = {"
aaaaaaaccccaaaaa
aaaacccfkkkcaaaa
aaacdffgeGhkcaaa
aacffffgijmkcaaa
aacJfYffLilkcaaa
aaccfffffgncaaaa
aaacffZfffpcaaaa
aaacTfoqofrcaaaa
saactttooucaaaaa
saaatvwooKcaaaaa
sssatxyztAcaaaaa
sssstxyCtcWVVaaa
ssssttDttaWEQMaa
ssssssssssOEFNaa
sssUssbsssWHIVaa
sssssssssbWVVaaa
"}
