//MAP CONVERTED BY dmm2tgm.py THIS HEADER COMMENT PREVENTS RECONVERSION, DO NOT REMOVE
"a" = (
/turf/template_noop,
/area/template_noop)
"c" = (
/turf/open/lava/smooth/lava_land_surface,
/area/ruin/unpowered)
"d" = (
/obj/effect/decal/remains/human,
/mob/living/simple_animal/hostile/carp/eyeball,
/turf/open/floor/plasteel/cult/airless,
/area/ruin/unpowered)
"e" = (
/obj/effect/decal/remains/human,
/turf/open/floor/plating/asteroid/basalt/lava_land_surface,
/area/ruin/unpowered)
"f" = (
/obj/effect/decal/cleanable/blood/gibs/human/limb,
/turf/open/floor/plasteel/cult/airless,
/area/ruin/unpowered)
"g" = (
/obj/effect/decal/cleanable/blood,
/turf/open/floor/plasteel/cult/airless,
/area/ruin/unpowered)
"l" = (
/obj/effect/decal/remains/human,
/turf/open/floor/plasteel/cult/airless,
/area/ruin/unpowered)
"o" = (
/obj/structure/lunaraltar,
/turf/open/floor/plasteel/cult/airless,
/area/ruin/unpowered)
"q" = (
/turf/open/floor/plasteel/cult/airless,
/area/ruin/unpowered)
"s" = (
/turf/open/floor/plating/asteroid/basalt/lava_land_surface,
/area/ruin/unpowered)
"x" = (
/obj/effect/decal/cleanable/blood,
/obj/effect/decal/cleanable/blood,
/turf/open/floor/plasteel/cult/airless,
/area/ruin/unpowered)
"y" = (
/obj/effect/decal/cleanable/blood/gibs/human,
/turf/open/floor/plasteel/cult/airless,
/area/ruin/unpowered)
"A" = (
/mob/living/simple_animal/hostile/carp/eyeball,
/turf/open/floor/plasteel/cult/airless,
/area/ruin/unpowered)
"R" = (
/obj/effect/decal/cleanable/ash/large,
/turf/open/floor/plasteel/cult/airless,
/area/ruin/unpowered)
"X" = (
/obj/effect/decal/cleanable/blood/gibs/human/lizard/limb,
/turf/open/floor/plasteel/cult/airless,
/area/ruin/unpowered)

(1,1,1) = {"
a
a
a
a
a
a
c
c
c
a
a
a
a
a
a
"}
(2,1,1) = {"
a
s
e
c
c
c
c
c
c
c
c
c
s
s
a
"}
(3,1,1) = {"
a
e
s
s
c
c
c
c
c
c
c
e
s
s
a
"}
(4,1,1) = {"
a
s
s
c
c
c
c
c
c
c
c
c
e
s
a
"}
(5,1,1) = {"
a
c
c
c
c
c
c
c
c
c
c
c
c
s
a
"}
(6,1,1) = {"
a
c
c
c
c
c
l
f
d
c
c
c
c
c
a
"}
(7,1,1) = {"
c
c
c
c
c
l
q
g
g
y
c
c
c
c
c
"}
(8,1,1) = {"
c
c
c
c
c
A
q
o
x
g
c
c
c
c
c
"}
(9,1,1) = {"
c
c
c
c
c
l
q
R
X
l
c
c
c
c
c
"}
(10,1,1) = {"
a
c
c
c
c
c
q
q
A
c
c
c
c
c
a
"}
(11,1,1) = {"
a
s
c
c
c
c
c
c
c
c
c
c
s
s
a
"}
(12,1,1) = {"
a
s
s
c
c
c
c
c
c
c
c
c
e
s
a
"}
(13,1,1) = {"
a
e
s
c
c
c
c
c
c
c
c
e
s
s
a
"}
(14,1,1) = {"
a
s
e
c
c
c
c
c
c
c
c
s
s
s
a
"}
(15,1,1) = {"
a
a
a
a
a
a
c
c
c
a
a
a
a
a
a
"}
