//MAP CONVERTED BY dmm2tgm.py THIS HEADER COMMENT PREVENTS RECONVERSION, DO NOT REMOVE
"aaa" = (
/turf/open/space/basic,
/area/space)
"aab" = (
/obj/structure/lattice,
/obj/machinery/atmospherics/pipe/simple/purple/visible{
	dir = 9
	},
/turf/open/space/basic,
/area/space/nearstation)
"aac" = (
/turf/closed/wall/r_wall,
/area/engine/engineering/reactor_control)
"aae" = (
/obj/machinery/atmospherics/pipe/simple/purple/visible,
/turf/closed/wall/r_wall,
/area/engine/engineering/reactor_control)
"aaf" = (
/obj/machinery/atmospherics/pipe/simple/scrubbers/hidden/layer3{
	dir = 4
	},
/obj/effect/spawner/structure/window/reinforced,
/obj/machinery/door/firedoor,
/turf/open/floor/plating,
/area/engine/atmos)
"aag" = (
/obj/machinery/atmospherics/pipe/simple/scrubbers/hidden/layer3{
	dir = 4
	},
/turf/closed/wall/r_wall,
/area/engine/engineering/reactor_control)
"aah" = (
/obj/structure/closet/radiation,
/obj/effect/turf_decal/delivery,
/obj/item/clothing/glasses/meson/engine,
/obj/machinery/atmospherics/pipe/manifold/scrubbers/hidden/layer3{
	dir = 1
	},
/obj/effect/turf_decal/stripes/line{
	dir = 9
	},
/turf/open/floor/plasteel/dark,
/area/engine/engineering/reactor_control)
"aai" = (
/obj/structure/closet/radiation,
/obj/effect/turf_decal/delivery,
/obj/item/clothing/glasses/meson/engine,
/obj/machinery/light/small{
	dir = 1
	},
/obj/machinery/atmospherics/pipe/simple/scrubbers/hidden/layer3{
	dir = 4
	},
/obj/machinery/firealarm{
	pixel_y = 24
	},
/obj/machinery/camera/autoname,
/obj/effect/turf_decal/stripes/line{
	dir = 1
	},
/turf/open/floor/plasteel/dark,
/area/engine/engineering/reactor_control)
"aaj" = (
/obj/structure/closet/emcloset,
/obj/machinery/atmospherics/pipe/simple/scrubbers/hidden/layer3{
	dir = 4
	},
/obj/structure/sign/warning/radiation{
	pixel_y = 32
	},
/obj/effect/turf_decal/stripes/line{
	dir = 5
	},
/turf/open/floor/plasteel/dark,
/area/engine/engineering/reactor_control)
"aak" = (
/obj/structure/closet/firecloset,
/obj/effect/turf_decal/stripes/line{
	dir = 9
	},
/obj/machinery/atmospherics/pipe/simple/scrubbers/hidden/layer3{
	dir = 4
	},
/turf/open/floor/plasteel/dark,
/area/engine/engineering/reactor_control)
"aal" = (
/obj/machinery/atmospherics/pipe/manifold/scrubbers/hidden/layer3{
	dir = 1
	},
/obj/machinery/firealarm{
	pixel_y = 24
	},
/obj/effect/turf_decal/stripes/line{
	dir = 1
	},
/obj/structure/table,
/obj/item/paper_bin,
/obj/item/pen,
/obj/machinery/atmospherics/pipe/simple/purple/visible{
	layer = 1
	},
/turf/open/floor/plasteel/dark,
/area/engine/engineering/reactor_control)
"aam" = (
/obj/machinery/atmospherics/pipe/simple/scrubbers/hidden/layer3{
	dir = 10
	},
/obj/structure/table,
/obj/machinery/computer/reactor/stats,
/obj/machinery/light{
	dir = 1
	},
/obj/effect/turf_decal/stripes/line{
	dir = 1
	},
/turf/open/floor/plasteel/dark,
/area/engine/engineering/reactor_control)
"aan" = (
/obj/machinery/airalarm{
	pixel_y = 22
	},
/obj/structure/table,
/obj/machinery/computer/reactor/fuel_rods,
/obj/machinery/camera/autoname,
/obj/effect/turf_decal/stripes/line{
	dir = 1
	},
/obj/machinery/atmospherics/pipe/simple/purple/visible,
/turf/open/floor/plasteel/dark,
/area/engine/engineering/reactor_control)
"aao" = (
/obj/structure/table,
/obj/machinery/computer/reactor/control_rods,
/obj/effect/turf_decal/stripes/line{
	dir = 1
	},
/turf/open/floor/plasteel/dark,
/area/engine/engineering/reactor_control)
"aap" = (
/obj/machinery/modular_computer/console/preset/engineering,
/obj/effect/turf_decal/stripes/line{
	dir = 1
	},
/turf/open/floor/plasteel/dark,
/area/engine/engineering/reactor_control)
"aaq" = (
/obj/machinery/computer/atmos_control/tank/toxin_tank{
	input_tag = "nuclear_mix_in";
	name = "Nuclear Reactor Gas Tank Control";
	output_tag = "nuclear_min_out";
	sensors = list("nuclear_mix_sensor" = "Nuclear Reactor Gas Mix Tank")
	},
/obj/effect/turf_decal/stripes/line{
	dir = 5
	},
/turf/open/floor/plasteel/dark,
/area/engine/engineering/reactor_control)
"aar" = (
/obj/structure/lattice,
/turf/open/space/basic,
/area/space/nearstation)
"aas" = (
/obj/machinery/light/small{
	dir = 1
	},
/obj/structure/cable/yellow{
	icon_state = "4-8"
	},
/turf/open/floor/plasteel/dark,
/area/engine/atmos)
"aat" = (
/obj/machinery/door/airlock/engineering{
	name = "Reactor Control";
	req_access_txt = "10"
	},
/obj/effect/mapping_helpers/airlock/cyclelink_helper{
	dir = 4
	},
/obj/effect/turf_decal/stripes/line{
	dir = 8
	},
/obj/effect/turf_decal/stripes/line{
	dir = 4
	},
/obj/machinery/door/firedoor/border_only{
	dir = 8
	},
/obj/machinery/door/firedoor/border_only{
	dir = 4
	},
/obj/structure/cable/yellow{
	icon_state = "4-8"
	},
/turf/open/floor/plasteel/dark,
/area/engine/engineering/reactor_control)
"aau" = (
/obj/machinery/atmospherics/components/unary/vent_scrubber/on/layer3{
	dir = 1
	},
/obj/structure/cable/yellow{
	icon_state = "4-8"
	},
/obj/effect/turf_decal/stripes/line{
	dir = 8
	},
/turf/open/floor/plasteel/dark,
/area/engine/engineering/reactor_control)
"aav" = (
/obj/structure/cable/yellow{
	icon_state = "4-8"
	},
/turf/open/floor/plasteel/dark,
/area/engine/engineering/reactor_control)
"aaw" = (
/obj/machinery/atmospherics/components/unary/vent_pump/on/layer1,
/obj/structure/cable/yellow{
	icon_state = "4-8"
	},
/obj/effect/turf_decal/stripes/line{
	dir = 4
	},
/turf/open/floor/plasteel/dark,
/area/engine/engineering/reactor_control)
"aax" = (
/obj/machinery/door/airlock/engineering{
	name = "Reactor Control";
	req_access_txt = "10"
	},
/obj/effect/mapping_helpers/airlock/cyclelink_helper{
	dir = 8
	},
/obj/effect/turf_decal/stripes/line{
	dir = 8
	},
/obj/effect/turf_decal/stripes/line{
	dir = 4
	},
/obj/machinery/door/firedoor/border_only{
	dir = 8
	},
/obj/machinery/door/firedoor/border_only{
	dir = 4
	},
/obj/structure/cable/yellow{
	icon_state = "4-8"
	},
/turf/open/floor/plasteel/dark,
/area/engine/engineering/reactor_control)
"aay" = (
/obj/structure/cable/yellow{
	icon_state = "4-8"
	},
/obj/effect/turf_decal/stripes/line{
	dir = 8
	},
/turf/open/floor/plasteel/dark,
/area/engine/engineering/reactor_control)
"aaz" = (
/obj/machinery/atmospherics/components/unary/vent_scrubber/on/layer3{
	dir = 1
	},
/obj/structure/cable/yellow{
	icon_state = "2-8"
	},
/obj/structure/cable/yellow{
	icon_state = "4-8"
	},
/obj/machinery/atmospherics/pipe/simple/purple/visible,
/turf/open/floor/carpet/royalblack,
/area/engine/engineering/reactor_control)
"aaA" = (
/obj/machinery/atmospherics/pipe/simple/scrubbers/hidden/layer3{
	dir = 1
	},
/obj/structure/chair/office/light{
	dir = 1
	},
/obj/structure/cable/yellow{
	icon_state = "4-8"
	},
/turf/open/floor/carpet/royalblack,
/area/engine/engineering/reactor_control)
"aaB" = (
/obj/structure/cable/yellow{
	icon_state = "4-8"
	},
/obj/machinery/atmospherics/pipe/simple/purple/visible,
/turf/open/floor/carpet/royalblack,
/area/engine/engineering/reactor_control)
"aaC" = (
/obj/structure/cable/yellow{
	icon_state = "4-8"
	},
/obj/structure/chair/office/light,
/turf/open/floor/carpet/royalblack,
/area/engine/engineering/reactor_control)
"aaD" = (
/obj/structure/cable/yellow{
	icon_state = "4-8"
	},
/turf/open/floor/carpet/royalblack,
/area/engine/engineering/reactor_control)
"aaE" = (
/obj/item/radio/intercom{
	pixel_x = 26
	},
/obj/structure/cable/yellow{
	icon_state = "2-8"
	},
/obj/effect/turf_decal/stripes/line{
	dir = 4
	},
/turf/open/floor/plasteel/dark,
/area/engine/engineering/reactor_control)
"aaF" = (
/obj/machinery/atmospherics/pipe/simple/supply/hidden/layer1{
	dir = 4
	},
/obj/effect/spawner/structure/window/reinforced,
/turf/open/floor/plating,
/area/engine/atmos)
"aaG" = (
/obj/machinery/atmospherics/pipe/simple/supply/hidden/layer1{
	dir = 4
	},
/turf/closed/wall/r_wall,
/area/engine/engineering/reactor_control)
"aaI" = (
/obj/machinery/shower{
	dir = 4
	},
/obj/machinery/atmospherics/pipe/simple/supply/hidden/layer1{
	dir = 4
	},
/obj/effect/turf_decal/stripes/line{
	dir = 10
	},
/turf/open/floor/noslip,
/area/engine/engineering/reactor_control)
"aaK" = (
/obj/machinery/atmospherics/pipe/simple/supply/hidden/layer1{
	dir = 4
	},
/obj/machinery/light/small,
/obj/effect/turf_decal/stripes/line,
/turf/open/floor/noslip,
/area/engine/engineering/reactor_control)
"aaL" = (
/obj/item/radio/intercom{
	pixel_x = 27
	},
/obj/machinery/shower{
	dir = 8
	},
/obj/machinery/atmospherics/pipe/manifold/supply/hidden/layer1,
/obj/effect/turf_decal/stripes/line{
	dir = 6
	},
/turf/open/floor/noslip,
/area/engine/engineering/reactor_control)
"aaN" = (
/obj/machinery/atmospherics/pipe/manifold/supply/hidden/layer1{
	dir = 1
	},
/turf/closed/wall/r_wall,
/area/engine/engineering/reactor_control)
"aaO" = (
/obj/machinery/atmospherics/pipe/simple/supply/hidden/layer1{
	dir = 4
	},
/obj/effect/turf_decal/stripes/line{
	dir = 10
	},
/turf/open/floor/plasteel/dark,
/area/engine/engineering/reactor_control)
"aaP" = (
/obj/machinery/atmospherics/pipe/simple/supply/hidden/layer1{
	dir = 4
	},
/obj/effect/turf_decal/stripes/line,
/obj/structure/cable/white{
	icon_state = "1-2"
	},
/obj/machinery/atmospherics/components/binary/pump{
	name = "Atmospherics to Reactor"
	},
/turf/open/floor/plasteel/dark,
/area/engine/engineering/reactor_control)
"aaR" = (
/obj/machinery/atmospherics/pipe/simple/scrubbers/hidden/layer3{
	dir = 1
	},
/obj/machinery/atmospherics/pipe/simple/supply/hidden/layer1{
	dir = 4
	},
/obj/effect/turf_decal/stripes/line,
/turf/open/floor/plasteel/dark,
/area/engine/engineering/reactor_control)
"aaT" = (
/obj/machinery/atmospherics/pipe/simple/supply/hidden/layer1{
	dir = 4
	},
/obj/effect/turf_decal/stripes/line,
/obj/machinery/atmospherics/components/binary/pump{
	name = "Atmospherics to Moderator"
	},
/turf/open/floor/plasteel/dark,
/area/engine/engineering/reactor_control)
"aaU" = (
/obj/machinery/atmospherics/pipe/simple/supply/hidden/layer1{
	dir = 4
	},
/obj/machinery/light,
/obj/machinery/computer/station_alert{
	dir = 1
	},
/obj/effect/turf_decal/stripes/line,
/turf/open/floor/plasteel/dark,
/area/engine/engineering/reactor_control)
"aaV" = (
/obj/machinery/atmospherics/components/unary/vent_pump/on/layer1{
	dir = 8
	},
/obj/structure/table,
/obj/machinery/button/door{
	id = "au_nuclear_vent";
	name = "RBMK Compartment Flush"
	},
/obj/effect/turf_decal/stripes/line,
/turf/open/floor/plasteel/dark,
/area/engine/engineering/reactor_control)
"aaW" = (
/obj/machinery/power/apc/auto_name/east,
/obj/structure/cable/yellow,
/obj/effect/turf_decal/stripes/line{
	dir = 6
	},
/turf/open/floor/plasteel/dark,
/area/engine/engineering/reactor_control)
"aaY" = (
/obj/structure/lattice,
/turf/open/space,
/area/space/nearstation)
"aaZ" = (
/obj/structure/cable/white{
	icon_state = "2-4"
	},
/turf/closed/wall/r_wall,
/area/engine/engineering/reactor_control)
"abe" = (
/obj/structure/cable/white{
	icon_state = "2-4"
	},
/obj/structure/cable/white{
	icon_state = "4-8"
	},
/turf/closed/wall/r_wall,
/area/engine/engineering/reactor_control)
"abf" = (
/obj/machinery/atmospherics/pipe/simple/supply/hidden/layer1,
/obj/structure/cable/white{
	icon_state = "4-8"
	},
/turf/closed/wall/r_wall,
/area/engine/engineering/reactor_control)
"abg" = (
/obj/effect/spawner/structure/window/plasma/reinforced,
/obj/structure/cable/white{
	icon_state = "4-8"
	},
/turf/open/floor/plating,
/area/engine/engineering/reactor_control)
"abh" = (
/obj/machinery/door/airlock/engineering{
	name = "Reactor Core";
	req_access_txt = "10"
	},
/obj/effect/turf_decal/stripes/line{
	dir = 1
	},
/obj/effect/turf_decal/stripes/line,
/obj/machinery/door/firedoor/border_only,
/obj/machinery/door/firedoor/border_only{
	dir = 1
	},
/obj/structure/cable/white{
	icon_state = "1-8"
	},
/obj/machinery/atmospherics/pipe/simple/scrubbers/visible,
/turf/open/floor/plasteel/dark,
/area/engine/engineering/reactor_control)
"abi" = (
/obj/effect/spawner/structure/window/plasma/reinforced,
/obj/machinery/atmospherics/pipe/simple/scrubbers/hidden/layer3{
	dir = 1
	},
/turf/open/floor/plating,
/area/engine/engineering/reactor_control)
"abj" = (
/obj/machinery/meter,
/obj/machinery/atmospherics/pipe/simple/brown/visible,
/turf/closed/wall/r_wall,
/area/engine/engineering/reactor_control)
"abk" = (
/obj/effect/spawner/structure/window/plasma/reinforced,
/turf/open/floor/plating,
/area/engine/engineering/reactor_control)
"abl" = (
/turf/closed/wall/r_wall,
/area/engine/engineering/reactor_core)
"abm" = (
/obj/machinery/power/smes/engineering,
/obj/structure/cable/white,
/obj/machinery/light{
	dir = 1
	},
/obj/effect/turf_decal/stripes/line{
	dir = 9
	},
/turf/open/floor/engine,
/area/engine/engineering/reactor_core)
"abn" = (
/obj/machinery/power/smes/engineering,
/obj/structure/cable/white,
/obj/effect/turf_decal/stripes/line{
	dir = 1
	},
/turf/open/floor/engine,
/area/engine/engineering/reactor_core)
"abq" = (
/obj/machinery/atmospherics/pipe/simple/supply/hidden/layer1,
/obj/structure/closet/secure_closet/engineering_welding,
/obj/effect/turf_decal/stripes/line{
	dir = 1
	},
/obj/machinery/airalarm{
	pixel_y = 22
	},
/turf/open/floor/engine,
/area/engine/engineering/reactor_core)
"abr" = (
/obj/effect/turf_decal/stripes/line{
	dir = 1
	},
/turf/open/floor/engine,
/area/engine/engineering/reactor_core)
"abs" = (
/obj/effect/turf_decal/stripes/line{
	dir = 1
	},
/obj/machinery/atmospherics/pipe/simple/scrubbers/visible,
/turf/open/floor/engine,
/area/engine/engineering/reactor_core)
"abt" = (
/obj/machinery/atmospherics/pipe/simple/scrubbers/hidden/layer3{
	dir = 5
	},
/obj/effect/turf_decal/stripes/line{
	dir = 1
	},
/turf/open/floor/engine,
/area/engine/engineering/reactor_core)
"abu" = (
/obj/machinery/atmospherics/pipe/simple/scrubbers/hidden/layer3{
	dir = 4
	},
/obj/machinery/camera/autoname,
/obj/effect/turf_decal/stripes/line{
	dir = 1
	},
/obj/machinery/atmospherics/pipe/manifold/brown/visible{
	dir = 8
	},
/turf/open/floor/engine,
/area/engine/engineering/reactor_core)
"abv" = (
/obj/machinery/atmospherics/pipe/simple/scrubbers/hidden/layer3{
	dir = 4
	},
/obj/machinery/power/apc/auto_name/north,
/obj/effect/turf_decal/stripes/line{
	dir = 1
	},
/obj/machinery/atmospherics/components/binary/pump{
	dir = 8;
	name = "Moderator to Reactor"
	},
/turf/open/floor/engine,
/area/engine/engineering/reactor_core)
"abw" = (
/obj/machinery/atmospherics/pipe/simple/scrubbers/hidden/layer3{
	dir = 10
	},
/obj/effect/turf_decal/stripes/line{
	dir = 1
	},
/obj/machinery/atmospherics/components/unary/portables_connector{
	dir = 8
	},
/obj/machinery/portable_atmospherics/canister/toxins,
/turf/open/floor/engine,
/area/engine/engineering/reactor_core)
"abA" = (
/obj/structure/table/reinforced,
/obj/machinery/light{
	dir = 1
	},
/obj/item/sealant,
/obj/effect/turf_decal/stripes/line{
	dir = 5
	},
/obj/item/sealant{
	pixel_x = 4
	},
/obj/item/reagent_containers/food/snacks/pizzaslice/meat{
	pixel_x = -1;
	pixel_y = 12
	},
/turf/open/floor/engine,
/area/engine/engineering/reactor_core)
"abB" = (
/obj/structure/grille/broken,
/obj/machinery/atmospherics/components/unary/outlet_injector/atmos/engine_waste{
	dir = 4
	},
/turf/open/floor/plating/airless,
/area/engine/engineering/reactor_core)
"abC" = (
/obj/machinery/atmospherics/pipe/simple/scrubbers/visible{
	dir = 4
	},
/obj/effect/spawner/structure/window/plasma/reinforced,
/turf/open/floor/engine,
/area/engine/engineering/reactor_core)
"abD" = (
/obj/machinery/atmospherics/pipe/simple/scrubbers/visible{
	dir = 4
	},
/obj/machinery/power/terminal{
	dir = 1
	},
/obj/structure/cable/yellow{
	icon_state = "0-2"
	},
/obj/effect/turf_decal/stripes/line{
	dir = 8
	},
/turf/open/floor/engine,
/area/engine/engineering/reactor_core)
"abE" = (
/obj/machinery/atmospherics/pipe/simple/scrubbers/visible{
	dir = 4
	},
/obj/machinery/power/terminal{
	dir = 1
	},
/obj/structure/cable/yellow{
	icon_state = "0-2"
	},
/turf/open/floor/engine,
/area/engine/engineering/reactor_core)
"abI" = (
/obj/machinery/power/terminal{
	dir = 1
	},
/obj/structure/cable/yellow{
	icon_state = "0-2"
	},
/obj/machinery/atmospherics/pipe/simple/scrubbers/visible{
	dir = 4
	},
/turf/open/floor/engine,
/area/engine/engineering/reactor_core)
"abJ" = (
/obj/machinery/atmospherics/pipe/simple/supply/hidden/layer1,
/obj/machinery/atmospherics/pipe/simple/scrubbers/visible{
	dir = 4
	},
/turf/open/floor/engine,
/area/engine/engineering/reactor_core)
"abK" = (
/obj/machinery/atmospherics/components/binary/valve/digital{
	dir = 4;
	name = "Emergency Coolant Purge"
	},
/turf/open/floor/engine,
/area/engine/engineering/reactor_core)
"abL" = (
/obj/machinery/atmospherics/pipe/manifold/scrubbers/visible{
	dir = 4
	},
/turf/open/floor/engine,
/area/engine/engineering/reactor_core)
"abM" = (
/turf/open/floor/engine,
/area/engine/engineering/reactor_core)
"abN" = (
/obj/machinery/meter,
/obj/machinery/atmospherics/pipe/manifold/brown/visible{
	dir = 8
	},
/turf/open/floor/engine,
/area/engine/engineering/reactor_core)
"abO" = (
/obj/machinery/atmospherics/components/binary/valve/digital{
	dir = 4;
	name = "Moderator Purge"
	},
/turf/open/floor/engine,
/area/engine/engineering/reactor_core)
"abP" = (
/obj/machinery/atmospherics/pipe/simple/scrubbers/hidden/layer3,
/obj/machinery/atmospherics/pipe/simple/brown/visible{
	dir = 8
	},
/turf/open/floor/engine,
/area/engine/engineering/reactor_core)
"abQ" = (
/obj/machinery/atmospherics/pipe/simple/brown/visible{
	dir = 8
	},
/turf/open/floor/engine,
/area/engine/engineering/reactor_core)
"abR" = (
/obj/effect/spawner/structure/window/plasma/reinforced,
/obj/machinery/atmospherics/pipe/simple/brown/visible{
	dir = 8
	},
/turf/open/floor/engine,
/area/engine/engineering/reactor_core)
"abS" = (
/obj/machinery/atmospherics/components/unary/outlet_injector/atmos/engine_waste{
	dir = 8
	},
/turf/open/floor/plating/airless,
/area/engine/engineering/reactor_core)
"abT" = (
/obj/structure/grille,
/obj/structure/lattice,
/turf/closed/wall/r_wall,
/area/space/nearstation)
"abU" = (
/obj/structure/cable/yellow{
	icon_state = "1-4"
	},
/obj/effect/turf_decal/stripes/line{
	dir = 8
	},
/turf/open/floor/engine,
/area/engine/engineering/reactor_core)
"abX" = (
/obj/structure/cable/yellow{
	icon_state = "1-4"
	},
/obj/structure/cable/yellow{
	icon_state = "1-8"
	},
/obj/structure/cable/yellow{
	icon_state = "4-8"
	},
/turf/open/floor/engine,
/area/engine/engineering/reactor_core)
"abY" = (
/obj/machinery/pool/filter{
	pixel_y = -18
	},
/obj/structure/cable/yellow{
	icon_state = "1-4"
	},
/obj/structure/cable/yellow{
	icon_state = "1-8"
	},
/obj/structure/cable/yellow{
	icon_state = "4-8"
	},
/turf/open/floor/engine,
/area/engine/engineering/reactor_core)
"abZ" = (
/obj/machinery/atmospherics/components/unary/vent_pump/on/layer1{
	dir = 1
	},
/obj/structure/cable/yellow{
	icon_state = "4-8"
	},
/turf/open/floor/engine,
/area/engine/engineering/reactor_core)
"aca" = (
/obj/machinery/pool/controller,
/obj/structure/cable/yellow{
	icon_state = "4-8"
	},
/turf/open/floor/engine,
/area/engine/engineering/reactor_core)
"acd" = (
/obj/effect/turf_decal/stripes/corner,
/obj/machinery/atmospherics/pipe/simple/scrubbers/visible,
/obj/structure/cable/yellow{
	icon_state = "4-8"
	},
/turf/open/floor/engine,
/area/engine/engineering/reactor_core)
"ace" = (
/obj/effect/turf_decal/stripes/line,
/obj/structure/cable/yellow{
	icon_state = "4-8"
	},
/turf/open/floor/engine,
/area/engine/engineering/reactor_core)
"ack" = (
/obj/machinery/atmospherics/components/binary/pump{
	name = "Moderators to Reactor"
	},
/obj/effect/turf_decal/stripes/line,
/obj/structure/cable/yellow{
	icon_state = "2-8"
	},
/turf/open/floor/engine,
/area/engine/engineering/reactor_core)
"acl" = (
/obj/effect/turf_decal/stripes/line,
/turf/open/floor/engine,
/area/engine/engineering/reactor_core)
"acp" = (
/obj/machinery/atmospherics/components/unary/vent_scrubber/on/layer3{
	dir = 1
	},
/obj/effect/turf_decal/stripes/corner{
	dir = 8
	},
/turf/open/floor/engine,
/area/engine/engineering/reactor_core)
"acq" = (
/obj/machinery/atmospherics/components/unary/portables_connector,
/obj/machinery/portable_atmospherics/canister/nitrogen,
/turf/open/floor/engine,
/area/engine/engineering/reactor_core)
"acr" = (
/obj/structure/grille/broken,
/obj/structure/lattice,
/turf/open/space,
/area/space/nearstation)
"acw" = (
/obj/effect/spawner/structure/window/plasma/reinforced,
/turf/open/floor/engine,
/area/engine/engineering/reactor_core)
"acx" = (
/obj/effect/turf_decal/stripes/line{
	dir = 8
	},
/turf/open/floor/engine,
/area/engine/engineering/reactor_core)
"acz" = (
/obj/effect/turf_decal/stripes/line{
	dir = 9
	},
/turf/open/pool,
/area/engine/engineering/reactor_core)
"acD" = (
/obj/item/twohanded/required/fuel_rod,
/obj/effect/turf_decal/stripes/line{
	dir = 1
	},
/obj/structure/pool/ladder{
	dir = 2;
	pixel_y = 17
	},
/turf/open/pool,
/area/engine/engineering/reactor_core)
"acE" = (
/obj/item/twohanded/required/fuel_rod,
/obj/effect/turf_decal/stripes/line{
	dir = 5
	},
/turf/open/pool,
/area/engine/engineering/reactor_core)
"acH" = (
/obj/effect/turf_decal/stripes/line{
	dir = 4
	},
/obj/machinery/atmospherics/pipe/simple/scrubbers/visible,
/turf/open/floor/engine,
/area/engine/engineering/reactor_core)
"acM" = (
/obj/machinery/atmospherics/pipe/simple/purple/visible,
/obj/structure/cable/yellow{
	icon_state = "1-2"
	},
/turf/open/floor/engine,
/area/engine/engineering/reactor_core)
"acP" = (
/obj/machinery/atmospherics/components/binary/pump{
	name = "Coolent to Reactor"
	},
/turf/open/floor/engine,
/area/engine/engineering/reactor_core)
"acQ" = (
/obj/effect/turf_decal/stripes/line{
	dir = 8
	},
/turf/open/pool,
/area/engine/engineering/reactor_core)
"acR" = (
/obj/machinery/pool/drain,
/obj/item/twohanded/required/fuel_rod,
/turf/open/pool,
/area/engine/engineering/reactor_core)
"acS" = (
/obj/item/twohanded/required/fuel_rod,
/obj/effect/turf_decal/stripes/line{
	dir = 4
	},
/turf/open/pool,
/area/engine/engineering/reactor_core)
"acT" = (
/obj/effect/turf_decal/stripes/line{
	dir = 4
	},
/obj/machinery/atmospherics/pipe/manifold/scrubbers/visible{
	dir = 8
	},
/obj/machinery/meter,
/turf/open/floor/engine,
/area/engine/engineering/reactor_core)
"acU" = (
/obj/machinery/atmospherics/pipe/simple/scrubbers/visible{
	dir = 4
	},
/turf/open/floor/engine,
/area/engine/engineering/reactor_core)
"acW" = (
/obj/structure/cable/yellow,
/obj/machinery/atmospherics/components/trinary/nuclear_reactor/preset,
/turf/open/floor/engine,
/area/engine/engineering/reactor_core)
"adb" = (
/obj/machinery/atmospherics/pipe/simple/cyan/visible{
	dir = 4
	},
/turf/open/floor/engine,
/area/engine/engineering/reactor_core)
"ade" = (
/obj/effect/turf_decal/stripes/line{
	dir = 8
	},
/obj/machinery/atmospherics/pipe/manifold/cyan/visible{
	dir = 1
	},
/obj/machinery/meter,
/turf/open/floor/engine,
/area/engine/engineering/reactor_core)
"adg" = (
/obj/machinery/atmospherics/pipe/simple/cyan/visible{
	dir = 9
	},
/turf/open/floor/engine,
/area/engine/engineering/reactor_core)
"adi" = (
/obj/effect/turf_decal/stripes/line,
/obj/effect/turf_decal/stripes/line{
	dir = 8
	},
/turf/open/floor/engine,
/area/engine/engineering/reactor_core)
"adj" = (
/obj/effect/turf_decal/stripes/corner{
	dir = 8
	},
/turf/open/floor/engine,
/area/engine/engineering/reactor_core)
"adl" = (
/obj/effect/turf_decal/stripes/line{
	dir = 10
	},
/turf/open/pool,
/area/engine/engineering/reactor_core)
"ads" = (
/obj/item/twohanded/required/fuel_rod,
/obj/effect/turf_decal/stripes/line,
/turf/open/pool,
/area/engine/engineering/reactor_core)
"adt" = (
/obj/item/twohanded/required/fuel_rod,
/obj/effect/turf_decal/stripes/line{
	dir = 6
	},
/turf/open/pool,
/area/engine/engineering/reactor_core)
"adu" = (
/obj/effect/turf_decal/stripes/line{
	dir = 8
	},
/obj/machinery/atmospherics/pipe/simple/cyan/visible,
/turf/open/floor/engine,
/area/engine/engineering/reactor_core)
"adw" = (
/obj/machinery/door/poddoor{
	id = "au_nuclear_vent"
	},
/turf/open/space/basic,
/area/engine/engineering/reactor_core)
"adx" = (
/obj/machinery/portable_atmospherics/canister/oxygen,
/obj/machinery/camera/autoname{
	dir = 4
	},
/obj/effect/turf_decal/stripes/line{
	dir = 8
	},
/turf/open/floor/engine,
/area/engine/engineering/reactor_core)
"ady" = (
/obj/effect/turf_decal/stripes/corner{
	dir = 4
	},
/obj/machinery/atmospherics/pipe/simple/scrubbers/visible,
/turf/open/floor/engine,
/area/engine/engineering/reactor_core)
"adD" = (
/obj/effect/turf_decal/stripes/line{
	dir = 1
	},
/obj/machinery/atmospherics/pipe/simple/cyan/visible{
	dir = 6
	},
/turf/open/floor/engine,
/area/engine/engineering/reactor_core)
"adE" = (
/obj/effect/turf_decal/stripes/line{
	dir = 1
	},
/obj/machinery/atmospherics/pipe/simple/cyan/visible{
	dir = 4
	},
/turf/open/floor/engine,
/area/engine/engineering/reactor_core)
"adF" = (
/obj/effect/turf_decal/stripes/corner{
	dir = 1
	},
/obj/machinery/atmospherics/pipe/simple/cyan/visible{
	dir = 9
	},
/turf/open/floor/engine,
/area/engine/engineering/reactor_core)
"adG" = (
/obj/machinery/portable_atmospherics/canister/toxins,
/obj/effect/turf_decal/stripes/line{
	dir = 10
	},
/turf/open/floor/engine,
/area/engine/engineering/reactor_core)
"adH" = (
/obj/effect/turf_decal/stripes/line{
	dir = 8
	},
/obj/machinery/light,
/obj/effect/turf_decal/stripes/line,
/turf/open/floor/engine,
/area/engine/engineering/reactor_core)
"adJ" = (
/obj/machinery/atmospherics/components/binary/pump{
	name = "Reactor to Cooling Loop"
	},
/obj/effect/turf_decal/stripes/line,
/turf/open/floor/engine,
/area/engine/engineering/reactor_core)
"adY" = (
/obj/machinery/atmospherics/components/binary/pump{
	dir = 1;
	name = "Cooling Loop to Reactor"
	},
/obj/effect/turf_decal/stripes/line,
/turf/open/floor/engine,
/area/engine/engineering/reactor_core)
"adZ" = (
/obj/machinery/light,
/obj/effect/turf_decal/stripes/line,
/turf/open/floor/engine,
/area/engine/engineering/reactor_core)
"aea" = (
/obj/effect/spawner/structure/window/plasma/reinforced,
/obj/machinery/atmospherics/pipe/layer_manifold,
/turf/open/floor/engine,
/area/engine/engineering/reactor_core)
"aeb" = (
/obj/structure/lattice,
/obj/structure/lattice,
/turf/open/space/basic,
/area/space/nearstation)
"aec" = (
/obj/machinery/atmospherics/pipe/heat_exchanging/junction,
/obj/machinery/atmospherics/pipe/heat_exchanging/junction/layer1,
/obj/structure/lattice,
/turf/open/space/basic,
/area/space/nearstation)
"aed" = (
/obj/machinery/atmospherics/pipe/heat_exchanging/simple{
	dir = 6
	},
/obj/machinery/atmospherics/pipe/heat_exchanging/simple/layer1{
	dir = 6
	},
/obj/structure/lattice/catwalk,
/turf/open/space/basic,
/area/space/nearstation)
"aee" = (
/obj/machinery/atmospherics/pipe/heat_exchanging/simple{
	dir = 4
	},
/obj/machinery/atmospherics/pipe/heat_exchanging/simple/layer1{
	dir = 4
	},
/obj/structure/lattice/catwalk,
/turf/open/space/basic,
/area/space/nearstation)
"aef" = (
/obj/machinery/atmospherics/pipe/heat_exchanging/simple{
	dir = 9
	},
/obj/machinery/atmospherics/pipe/heat_exchanging/simple/layer1{
	dir = 9
	},
/obj/structure/lattice/catwalk,
/turf/open/space/basic,
/area/space/nearstation)
"aeg" = (
/obj/machinery/atmospherics/pipe/heat_exchanging/simple{
	dir = 5
	},
/obj/machinery/atmospherics/pipe/heat_exchanging/simple/layer1{
	dir = 5
	},
/obj/structure/lattice/catwalk,
/turf/open/space/basic,
/area/space/nearstation)
"aeh" = (
/obj/machinery/atmospherics/pipe/heat_exchanging/simple{
	dir = 10
	},
/obj/machinery/atmospherics/pipe/heat_exchanging/simple/layer1{
	dir = 10
	},
/obj/structure/lattice/catwalk,
/turf/open/space/basic,
/area/space/nearstation)

(1,1,1) = {"
aab
aaf
aas
aaF
aaY
aaa
abB
abT
acr
abT
abT
aaY
aaY
aaa
aar
aaa
aar
"}
(2,1,1) = {"
aac
aag
aat
aaG
aac
abl
abC
abl
acw
acw
abl
abl
abl
abl
aar
aaa
aar
"}
(3,1,1) = {"
aac
aah
aau
aaI
aaZ
abm
abD
abU
acx
acx
adi
adx
adG
abl
aar
aed
aeg
"}
(4,1,1) = {"
aac
aai
aav
aaK
abe
abn
abE
abX
abM
abM
adj
acx
adH
abl
aar
aee
aee
"}
(5,1,1) = {"
aac
aaj
aaw
aaL
abe
abn
abI
abY
acz
acQ
adl
abM
acl
acw
aar
aee
aee
"}
(6,1,1) = {"
aac
aag
aax
aaN
abf
abq
abJ
abZ
acD
acR
ads
abM
acl
acw
aeb
aee
aee
"}
(7,1,1) = {"
aac
aak
aay
aaO
abg
abr
abK
aca
acE
acS
adt
abM
acl
acw
aar
aee
aee
"}
(8,1,1) = {"
aae
aal
aaz
aaP
abh
abs
abL
acd
acH
acT
acH
ady
adJ
aea
aec
aef
aee
"}
(9,1,1) = {"
aac
aam
aaA
aaR
abi
abt
abM
ace
abM
acU
abM
adD
adY
aea
aec
aeg
aee
"}
(10,1,1) = {"
aae
aan
aaB
aaT
abj
abu
abN
ack
acM
acW
abM
adE
acl
acw
aar
aee
aee
"}
(11,1,1) = {"
aac
aao
aaC
aaU
aac
abv
abO
acl
abM
adb
abM
adE
acl
acw
aar
aee
aee
"}
(12,1,1) = {"
aac
aap
aaD
aaV
abk
abw
abP
acp
acx
ade
adu
adF
adZ
abl
aar
aee
aee
"}
(13,1,1) = {"
aac
aaq
aaE
aaW
aac
abA
abQ
acq
acP
adg
abM
abM
acl
abl
aar
aeh
aef
"}
(14,1,1) = {"
aac
aac
aac
aac
aac
abl
abR
abl
acw
acw
adw
adw
adw
abl
aaa
aaa
aar
"}
(15,1,1) = {"
aaa
aar
aaa
aaa
aar
aaa
abS
aar
aaa
aaa
aaa
aaa
aaa
aar
aaa
aaa
aar
"}
