//MAP CONVERTED BY dmm2tgm.py THIS HEADER COMMENT PREVENTS RECONVERSION, DO NOT REMOVE
"aa" = (
/turf/template_noop,
/area/template_noop)
"ab" = (
/turf/closed/mineral/random,
/area/ruin/unpowered/no_grav)
"aq" = (
/obj/structure/flora/rock/pile,
/obj/effect/decal/cleanable/dirt,
/turf/open/floor/plating/asteroid/airless,
/area/ruin/unpowered/no_grav)
"ay" = (
/obj/effect/decal/cleanable/dirt,
/obj/structure/girder,
/turf/open/floor/plating/asteroid/airless,
/area/ruin/unpowered/no_grav)
"aD" = (
/obj/effect/decal/cleanable/oil,
/turf/open/floor/plating/airless,
/area/ruin/unpowered/no_grav)
"aQ" = (
/obj/effect/turf_decal/sand/plating,
/turf/open/floor/plating/asteroid/airless,
/area/ruin/unpowered/no_grav)
"bd" = (
/obj/effect/decal/cleanable/dirt,
/obj/effect/decal/cleanable/dirt,
/turf/open/floor/plating/asteroid/airless,
/area/ruin/unpowered/no_grav)
"bx" = (
/obj/structure/flora/grass/jungle/b,
/turf/open/floor/plating/asteroid/airless,
/area/ruin/unpowered/no_grav)
"bE" = (
/obj/effect/decal/cleanable/dirt,
/obj/effect/decal/cleanable/oil,
/turf/open/floor/plating/airless,
/area/ruin/unpowered/no_grav)
"bJ" = (
/obj/docking_port/stationary{
	dir = 4;
	dwidth = 6;
	height = 7;
	id = "caravansyndicate3_listeningpost";
	name = "Syndicate Listening Post";
	width = 15
	},
/obj/docking_port/stationary{
	dir = 4;
	dwidth = 4;
	height = 5;
	id = "caravansyndicate1_listeningpost";
	name = "Syndicate Listening Post";
	width = 9
	},
/turf/template_noop,
/area/template_noop)
"cl" = (
/turf/template_noop,
/area/ruin/unpowered/no_grav)
"cs" = (
/obj/structure/lattice,
/turf/template_noop,
/area/ruin/unpowered/no_grav)
"cI" = (
/obj/effect/turf_decal/sand/plating,
/turf/open/floor/plating,
/area/ruin/unpowered/no_grav)
"cN" = (
/obj/structure/flora/rock,
/turf/open/floor/plating/asteroid/airless,
/area/ruin/unpowered/no_grav)
"cR" = (
/obj/structure/flora/rock/pile,
/turf/open/floor/plating/asteroid/airless,
/area/ruin/unpowered/no_grav)
"dx" = (
/turf/closed/wall/mineral/plastitanium/nodiagonal,
/area/ruin/unpowered/no_grav)
"dy" = (
/obj/structure/girder,
/turf/open/floor/plating/asteroid/airless,
/area/ruin/unpowered/no_grav)
"dO" = (
/obj/structure/flora/rock,
/obj/effect/decal/cleanable/dirt,
/turf/open/floor/plating/asteroid/airless,
/area/ruin/unpowered/no_grav)
"dT" = (
/obj/structure/lattice,
/turf/open/floor/plating/asteroid/airless,
/area/ruin/unpowered/no_grav)
"dY" = (
/obj/structure/flora/junglebush/large,
/turf/open/floor/plating/asteroid/airless,
/area/ruin/unpowered/no_grav)
"dZ" = (
/obj/item/shard,
/obj/effect/turf_decal/sand/plating,
/turf/open/floor/plating/asteroid/airless,
/area/ruin/unpowered/no_grav)
"ea" = (
/obj/effect/decal/cleanable/cobweb/cobweb2,
/obj/structure/trash_pile,
/turf/open/floor/plating/asteroid/airless,
/area/ruin/unpowered/no_grav)
"eb" = (
/obj/structure/flora/rock/pile,
/obj/structure/flora/junglebush/c{
	pixel_y = 15
	},
/turf/open/floor/plating/asteroid/airless,
/area/ruin/unpowered/no_grav)
"ee" = (
/obj/structure/flora/rock/pile,
/obj/structure/flora/junglebush/c,
/turf/open/floor/plating/asteroid/airless,
/area/ruin/unpowered/no_grav)
"ef" = (
/obj/structure/barricade/wooden,
/turf/open/floor/plating/asteroid/airless,
/area/ruin/unpowered/no_grav)
"eg" = (
/obj/structure/flora/grass/jungle/b,
/obj/effect/decal/cleanable/dirt,
/turf/open/floor/plating/asteroid/airless,
/area/ruin/unpowered/no_grav)
"er" = (
/obj/effect/decal/cleanable/dirt,
/turf/open/floor/plating/asteroid/airless,
/area/ruin/unpowered/no_grav)
"ez" = (
/obj/effect/decal/cleanable/dirt,
/turf/open/floor/plating/airless,
/area/ruin/unpowered/no_grav)
"Bs" = (
/turf/open/floor/plating/airless,
/area/ruin/unpowered/no_grav)
"Lx" = (
/turf/open/floor/plating/asteroid/airless,
/area/ruin/unpowered/no_grav)

(1,1,1) = {"
aa
aa
aa
aa
aa
aa
aa
aa
aa
aa
aa
aa
aa
aa
aa
aa
ab
ab
ab
ab
ab
aa
aa
aa
aa
aa
aa
aa
aa
aa
aa
aa
aa
aa
aa
aa
aa
aa
"}
(2,1,1) = {"
aa
aa
aa
aa
aa
aa
ab
ab
ab
ab
ab
aa
aa
aa
ab
ab
ab
ab
ab
ab
ab
ab
ab
ab
ab
aa
aa
aa
aa
aa
aa
aa
aa
aa
aa
aa
aa
aa
"}
(3,1,1) = {"
aa
aa
aa
aa
aa
ab
ab
ab
ab
ab
ab
ab
aa
ab
ab
ab
ab
ab
ab
ab
ab
ab
ab
ab
ab
ab
ab
ab
ab
ab
aa
ab
ab
ab
aa
aa
aa
aa
"}
(4,1,1) = {"
aa
aa
aa
aa
ab
ab
ab
ab
ab
ab
ab
ab
ab
ab
ab
ab
ab
ab
ab
ab
ab
ab
ab
ab
ab
ab
ab
ab
ab
ab
ab
ab
ab
ab
ab
aa
aa
aa
"}
(5,1,1) = {"
aa
aa
aa
ab
ab
ab
ab
ab
ab
ab
ab
ab
ab
ab
ab
ab
ab
ab
ab
ab
cR
ab
ab
ab
ab
ab
ab
ab
ab
ab
ab
ab
ab
ab
ab
aa
aa
aa
"}
(6,1,1) = {"
aa
aa
aa
ab
ab
ab
ab
ab
ab
ab
ab
ab
ab
ab
ab
ab
Lx
Lx
Lx
Lx
Lx
Lx
Lx
ab
ab
ab
ab
ab
ab
ab
ab
ab
ab
ab
ab
ab
ab
aa
"}
(7,1,1) = {"
aa
aa
ab
ab
ab
ab
ab
ab
ab
ab
ab
ab
ab
ab
ab
Lx
er
Lx
Lx
Lx
Lx
Lx
Lx
Lx
Lx
ab
ab
ab
ab
ab
ab
ab
ab
ab
ab
ab
ab
aa
"}
(8,1,1) = {"
aa
aa
ab
ab
ab
ab
ab
ab
ab
ab
ab
ab
ab
Lx
Lx
Lx
er
er
cR
Lx
er
Lx
Lx
Lx
Lx
ab
ab
cR
cR
ab
ab
ab
ab
ab
ab
ab
ab
aa
"}
(9,1,1) = {"
aa
aa
ab
ab
ab
ab
ab
ab
ab
ab
ab
ab
ab
Lx
Lx
er
er
er
er
cR
er
Lx
Bs
Lx
Lx
Lx
er
er
ee
ab
ab
ab
ab
ab
ab
ab
ab
aa
"}
(10,1,1) = {"
aa
aa
aa
ab
ab
ab
ab
ab
ab
ab
Lx
ab
ab
Lx
Lx
er
er
er
er
Lx
Bs
Lx
Lx
Lx
cR
er
dO
Lx
dY
eb
ab
ab
ab
ab
ab
ab
ab
aa
"}
(11,1,1) = {"
aa
aa
aa
ab
ab
ab
ab
ab
ab
ab
Lx
Lx
ab
Lx
Lx
Lx
cR
Lx
er
Bs
Bs
Lx
dx
er
er
er
Lx
Lx
dZ
Lx
ee
ab
ab
ab
ab
ab
aa
aa
"}
(12,1,1) = {"
aa
aa
aa
ab
ab
ab
ab
ab
ab
ab
Lx
Lx
Lx
ab
Lx
Lx
Lx
dT
Bs
Bs
Lx
er
dy
er
er
Lx
Lx
Lx
ea
Lx
ef
ab
ab
ab
ab
ab
aa
aa
"}
(13,1,1) = {"
aa
aa
aa
ab
ab
ab
ab
ab
ab
ab
Lx
Lx
cN
er
er
er
Lx
dT
ez
Bs
Lx
Lx
dy
dy
dx
dx
dT
Lx
Lx
er
eg
Lx
ab
ab
ab
ab
ab
aa
"}
(14,1,1) = {"
aa
aa
aa
ab
ab
ab
ab
ab
ab
ab
Lx
Lx
Lx
er
er
er
Lx
dT
ez
ez
Lx
Lx
cR
Lx
Lx
Lx
dT
Lx
Lx
Lx
Lx
er
bx
ab
ab
ab
ab
aa
"}
(15,1,1) = {"
aa
aa
aa
ab
ab
ab
ab
ab
ab
ab
Lx
er
Lx
er
er
cR
er
dy
bE
ez
Lx
cl
cl
cl
Lx
Lx
dT
dT
er
Lx
er
er
er
Lx
ab
ab
ab
aa
"}
(16,1,1) = {"
aa
aa
aa
ab
ab
ab
ab
ab
ab
ab
Lx
Lx
Lx
ab
ab
Lx
Lx
Lx
ez
Bs
cl
cl
cl
cl
cl
aQ
dT
dT
Lx
Lx
er
Lx
cR
Lx
ab
ab
ab
aa
"}
(17,1,1) = {"
aa
aa
ab
ab
ab
ab
ab
ab
ab
ab
Lx
Lx
ab
ab
Bs
Lx
Lx
Bs
ez
Bs
cl
cl
cl
cl
Lx
aQ
dT
dT
dT
Bs
Lx
Lx
Lx
Lx
Lx
ab
ab
aa
"}
(18,1,1) = {"
aa
ab
ab
ab
ab
ab
ab
ab
ab
ab
ab
ab
ab
ab
Lx
Lx
Lx
ez
Bs
Bs
Bs
cs
cs
cI
cR
Lx
dT
Bs
dT
ez
Bs
Lx
Lx
Lx
er
ab
ab
aa
"}
(19,1,1) = {"
aa
ab
ab
ab
ab
ab
ab
ab
ab
ab
ab
ab
ab
Lx
Bs
Lx
er
Bs
ez
ez
ez
Bs
Bs
Lx
Bs
Bs
dT
ez
Bs
Bs
Bs
Lx
er
Lx
er
ab
ab
aa
"}
(20,1,1) = {"
ab
ab
ab
ab
ab
ab
ab
ab
ab
ab
ab
ab
ab
cR
Lx
Lx
Lx
Bs
Bs
ez
ez
ez
ez
aD
Bs
Bs
dT
Bs
Bs
ez
Bs
er
Lx
Lx
er
ab
ab
ab
"}
(21,1,1) = {"
ab
ab
ab
ab
ab
ab
ab
ab
ab
ab
ab
Lx
Lx
Lx
Lx
Lx
Bs
Bs
dT
dy
dT
dT
dT
dT
dT
Lx
Lx
Lx
Bs
ez
ez
Lx
Lx
Lx
er
ab
ab
ab
"}
(22,1,1) = {"
ab
ab
ab
ab
ab
ab
ab
ab
ab
Lx
Lx
Lx
Lx
Lx
Lx
cR
Bs
Bs
dT
dy
Lx
cs
cs
cs
cI
er
Lx
Lx
Bs
Bs
Bs
cR
Lx
er
er
ab
ab
ab
"}
(23,1,1) = {"
aa
ab
ab
ab
ab
ab
ab
ab
Lx
Lx
er
Lx
cR
er
Lx
Bs
ez
dT
dT
dx
ab
cl
cl
cl
cl
Lx
er
Lx
Bs
Lx
Lx
Lx
er
ab
ab
ab
ab
ab
"}
(24,1,1) = {"
aa
ab
ab
ab
ab
ab
ab
ab
Lx
Lx
Lx
Lx
Lx
Lx
Lx
Bs
ez
dT
Lx
dx
ab
ab
cl
cl
cl
Lx
cR
Lx
Lx
Lx
Lx
Lx
er
ab
ab
ab
ab
ab
"}
(25,1,1) = {"
aa
ab
ab
ab
ab
ab
ab
Lx
Lx
Lx
cN
Lx
er
Lx
Lx
Bs
dT
Lx
Lx
ay
ab
ab
ab
Lx
cN
er
Lx
Lx
er
Lx
Lx
er
er
ab
ab
ab
ab
ab
"}
(26,1,1) = {"
aa
ab
ab
ab
ab
ab
Lx
aq
Lx
Lx
cR
Lx
Lx
dT
dT
dT
dT
Lx
er
Lx
Lx
ab
ab
ab
ab
Lx
Lx
Lx
Lx
Lx
Lx
bd
er
ab
ab
ab
ab
aa
"}
(27,1,1) = {"
aa
aa
ab
ab
ab
ab
Lx
Lx
Lx
Lx
Lx
dT
dT
dT
dT
dT
dT
Lx
cR
er
Lx
ab
dx
dx
dx
dx
ab
ab
Lx
er
er
er
ab
ab
ab
ab
ab
aa
"}
(28,1,1) = {"
aa
aa
aa
aa
ab
ab
er
Lx
er
Lx
Lx
Lx
dT
Lx
Lx
Lx
er
Lx
Lx
Lx
Lx
ab
ab
ab
ab
ab
ab
ab
ab
ab
ab
ab
ab
ab
ab
ab
aa
aa
"}
(29,1,1) = {"
aa
aa
aa
aa
aa
ab
Lx
Lx
Lx
cR
Lx
Lx
Lx
Lx
Lx
Lx
Lx
Lx
Lx
Lx
ab
ab
ab
ab
ab
ab
ab
ab
ab
ab
ab
ab
ab
ab
aa
aa
aa
aa
"}
(30,1,1) = {"
aa
aa
aa
aa
aa
ab
ab
ab
Lx
Lx
Lx
Lx
aq
Lx
Lx
Lx
ab
Lx
ab
ab
ab
ab
ab
ab
ab
ab
ab
ab
ab
ab
ab
aa
aa
aa
aa
aa
aa
aa
"}
(31,1,1) = {"
aa
aa
aa
aa
aa
aa
aa
aa
Lx
Lx
Lx
Lx
ab
ab
ab
ab
ab
ab
ab
ab
ab
ab
ab
ab
ab
ab
ab
ab
aa
aa
aa
aa
aa
aa
aa
aa
aa
aa
"}
(32,1,1) = {"
aa
aa
aa
aa
aa
aa
aa
aa
aa
bJ
aa
aa
aa
aa
aa
aa
aa
aa
ab
ab
ab
ab
ab
ab
aa
aa
aa
aa
aa
aa
aa
aa
aa
aa
aa
aa
aa
aa
"}
