//MAP CONVERTED BY dmm2tgm.py THIS HEADER COMMENT PREVENTS RECONVERSION, DO NOT REMOVE
"aa" = (
/turf/template_noop,
/area/template_noop)
"ab" = (
/turf/closed/mineral/random/low_chance,
/area/ruin/unpowered)
"ac" = (
/obj/machinery/hydroponics/soil,
/turf/open/floor/plating/asteroid/spacehermit,
/area/ruin/unpowered)
"ad" = (
/obj/structure/table/wood,
/obj/item/shovel,
/turf/open/floor/plating/asteroid/spacehermit,
/area/ruin/unpowered)
"ae" = (
/turf/closed/wall/mineral/titanium,
/area/ruin/powered)
"af" = (
/obj/effect/spawner/structure/window/shuttle,
/turf/open/floor/mineral/titanium,
/area/ruin/powered)
"ag" = (
/obj/structure/shuttle/engine/propulsion/right{
	dir = 4
	},
/turf/closed/wall/mineral/titanium,
/area/ruin/powered)
"ah" = (
/turf/open/floor/plating/asteroid/spacehermit,
/area/ruin/unpowered)
"ai" = (
/obj/structure/lattice,
/turf/template_noop,
/area/template_noop)
"aj" = (
/obj/machinery/computer/cryopod,
/turf/closed/wall/mineral/titanium,
/area/ruin/powered)
"ak" = (
/obj/structure/fluff/empty_cryostasis_sleeper,
/turf/open/floor/mineral/titanium,
/area/ruin/powered)
"al" = (
/obj/machinery/status_display/shuttle,
/turf/closed/wall/mineral/titanium,
/area/ruin/powered)
"am" = (
/obj/item/seeds/tower,
/obj/item/seeds/tower,
/obj/item/seeds/tower,
/turf/open/floor/plating/asteroid/spacehermit,
/area/ruin/unpowered)
"an" = (
/turf/open/floor/mineral/titanium,
/area/ruin/powered)
"ao" = (
/obj/structure/chair/comfy/shuttle{
	dir = 8
	},
/turf/open/floor/mineral/titanium,
/area/ruin/powered)
"ap" = (
/obj/machinery/light{
	dir = 1
	},
/turf/open/floor/mineral/titanium,
/area/ruin/powered)
"aq" = (
/obj/machinery/computer{
	desc = "A computer long since rendered non-functional due to lack of maintenance. Spitting out error messages.";
	dir = 4;
	name = "Broken Computer"
	},
/turf/open/floor/mineral/titanium,
/area/ruin/powered)
"ar" = (
/obj/machinery/door/airlock/titanium{
	name = "Escape Pod Airlock"
	},
/turf/open/floor/mineral/titanium,
/area/ruin/powered)
"as" = (
/obj/machinery/light,
/turf/open/floor/mineral/titanium,
/area/ruin/powered)
"at" = (
/obj/structure/shuttle/engine/propulsion/left{
	dir = 4
	},
/turf/closed/wall/mineral/titanium,
/area/ruin/powered)
"au" = (
/obj/item/stack/sheet/mineral/wood,
/obj/item/stack/sheet/mineral/wood,
/obj/item/stack/sheet/mineral/wood,
/obj/item/stack/sheet/mineral/wood,
/obj/item/stack/sheet/mineral/wood,
/turf/open/floor/plating/asteroid/spacehermit,
/area/ruin/unpowered)
"av" = (
/obj/item/twohanded/spear,
/turf/open/floor/plating/asteroid/spacehermit,
/area/ruin/unpowered)
"aw" = (
/obj/item/grown/log,
/obj/item/grown/log,
/turf/open/floor/plating/asteroid/spacehermit,
/area/ruin/unpowered)
"ax" = (
/obj/structure/table/wood,
/obj/item/storage/bag/plants/portaseeder,
/turf/open/floor/plating/asteroid/spacehermit,
/area/ruin/unpowered)
"ay" = (
/obj/item/flashlight/lamp/bananalamp,
/turf/open/floor/plating/asteroid/spacehermit,
/area/ruin/unpowered)
"az" = (
/obj/item/seeds/banana,
/obj/item/seeds/banana,
/turf/open/floor/plating/asteroid/spacehermit,
/area/ruin/unpowered)
"aA" = (
/turf/open/floor/plating/asteroid/airless,
/area/ruin/unpowered)
"aB" = (
/obj/effect/mob_spawn/human/clown/corpse,
/obj/structure/fans/tiny/invisible,
/turf/open/floor/plating/asteroid/spacehermit,
/area/ruin/unpowered)
"aC" = (
/obj/item/mining_scanner,
/turf/open/floor/plating/asteroid/spacehermit,
/area/ruin/unpowered)
"aD" = (
/obj/item/circuitboard/computer/rdconsole,
/obj/item/circuitboard/machine/protolathe/department/science,
/turf/open/floor/plating/asteroid/spacehermit,
/area/ruin/unpowered)
"aE" = (
/obj/machinery/status_display/shuttle,
/turf/closed/wall/mineral/titanium,
/area/ruin/unpowered)
"aF" = (
/obj/item/pickaxe/emergency,
/turf/open/floor/plating/asteroid/spacehermit,
/area/ruin/unpowered)
"aG" = (
/obj/structure/sink/puddle,
/turf/open/floor/plating/asteroid/spacehermit,
/area/ruin/unpowered)
"aH" = (
/obj/structure/table/wood,
/obj/item/storage/firstaid/regular,
/turf/open/floor/plating/asteroid/spacehermit,
/area/ruin/unpowered)
"aI" = (
/obj/effect/mob_spawn/human/corpse/assistant,
/turf/template_noop,
/area/template_noop)
"aJ" = (
/obj/structure/table/wood,
/obj/item/storage/bag/ore,
/turf/open/floor/plating/asteroid/spacehermit,
/area/ruin/unpowered)
"aK" = (
/obj/structure/reagent_dispensers/fueltank,
/turf/open/floor/plating/asteroid/spacehermit,
/area/ruin/unpowered)
"aL" = (
/obj/structure/table/wood,
/obj/item/storage/toolbox/mechanical,
/obj/item/clothing/head/welding,
/turf/open/floor/plating/asteroid/spacehermit,
/area/ruin/unpowered)
"aM" = (
/mob/living/simple_animal/hostile/carp,
/turf/template_noop,
/area/template_noop)
"aN" = (
/obj/structure/mineral_door/sandstone,
/turf/open/floor/plating/asteroid/spacehermit,
/area/ruin/unpowered)
"aO" = (
/mob/living/simple_animal/hostile/carp,
/turf/open/floor/plating/asteroid/airless,
/area/ruin/unpowered)
"aP" = (
/obj/item/stack/ore/gold,
/turf/open/floor/plating/asteroid/spacehermit,
/area/ruin/unpowered)
"aQ" = (
/obj/item/stack/ore/gold,
/obj/item/stack/ore/gold,
/obj/item/stack/ore/gold,
/turf/open/floor/plating/asteroid/spacehermit,
/area/ruin/unpowered)
"aR" = (
/obj/item/stack/ore/iron,
/turf/open/floor/plating/asteroid/spacehermit,
/area/ruin/unpowered)
"aS" = (
/turf/closed/wall/mineral/iron,
/area/ruin/unpowered)
"aT" = (
/obj/item/stack/ore/iron,
/obj/item/stack/ore/iron,
/turf/open/floor/plating/asteroid/spacehermit,
/area/ruin/unpowered)
"aU" = (
/obj/item/flashlight/lamp,
/obj/structure/table/wood,
/turf/open/floor/plating/asteroid/spacehermit,
/area/ruin/unpowered)
"aV" = (
/obj/item/clothing/suit/space/orange,
/turf/template_noop,
/area/template_noop)
"aW" = (
/obj/item/clothing/head/helmet/space/orange,
/turf/template_noop,
/area/template_noop)
"aX" = (
/mob/living/simple_animal/hostile/carp/megacarp,
/turf/template_noop,
/area/template_noop)
"aY" = (
/obj/effect/mob_spawn/human/hermit{
	flavour_text = "You've been late to awaken from your cryo slumber. Blasted machine, you set it to 10 days not 10 weeks! Where have the others gone while we were out? Did they manage to survive? These thoughts are dispelled by yet another recollection of how you got here... ";
	job_description = "Space Hermit"
	},
/turf/open/floor/mineral/titanium,
/area/ruin/powered)
"aZ" = (
/turf/closed/wall/mineral/titanium,
/area/ruin/unpowered)
"ba" = (
/obj/effect/spawner/structure/window/shuttle,
/turf/open/floor/mineral/titanium,
/area/ruin/unpowered)
"bb" = (
/obj/structure/shuttle/engine/propulsion/left{
	dir = 4
	},
/turf/closed/wall/mineral/titanium,
/area/ruin/unpowered)
"bc" = (
/obj/structure/table/wood,
/obj/item/paper/crumpled{
	info = "</b><br><br>So this is it, I guess.. Always thought I'd go out doing something stupid, but.. not like this.<br>Should anyone find this note, tell Jeremy Clarke he can kiss my ass. Launching the pod unprepared like that..<br>Well. Now that I'm keeling over here, I guess I should write how I came to be the last one standing here.<br>Four of us took this pod.. only three of us woke up though.. fourth pod is locked from the inside, we couldn't figure out how to get it open.<br>Me and the clown set up a farm s'we can survive at least a while.. though, he didn't seem to understand that man cannot live on banana alone.<br>Had a bunch of circuits on him for some reason when he eventually passed, whispered to me something about a chem dispenser.. I.. don't know what he meant by that. I was never good with machinary. Maybe he wanted space lube?<br>The assistant that we gave the space suit to go out and find help never came back.. I'm betting he found salvation and left us behind.. never can trust those grubby greytiders."
	},
/obj/item/pen,
/obj/item/bluespace_thread{
	pixel_x = -1;
	pixel_y = 1
	},
/turf/open/floor/plating/asteroid/spacehermit,
/area/ruin/unpowered)
"bd" = (
/obj/item/circuitboard/machine/circuit_imprinter,
/turf/open/floor/plating/asteroid/spacehermit,
/area/ruin/unpowered)
"be" = (
/obj/item/grown/bananapeel,
/turf/open/floor/plating/asteroid/spacehermit,
/area/ruin/unpowered)
"bf" = (
/obj/effect/mob_spawn/human/corpse/cargo_tech,
/obj/structure/fans/tiny/invisible,
/obj/effect/decal/cleanable/vomit,
/turf/open/floor/plating/asteroid/spacehermit,
/area/ruin/unpowered)
"bg" = (
/obj/item/clothing/glasses/meson,
/turf/open/floor/plating/asteroid/spacehermit,
/area/ruin/unpowered)
"bh" = (
/obj/item/circuitboard/machine/autolathe,
/turf/open/floor/mineral/titanium,
/area/ruin/powered)
"bi" = (
/obj/item/stock_parts/matter_bin,
/turf/open/floor/plating/asteroid/spacehermit,
/area/ruin/unpowered)
"bj" = (
/obj/item/stock_parts/manipulator,
/turf/open/floor/plating/asteroid/spacehermit,
/area/ruin/unpowered)
"bk" = (
/obj/structure/holosign/barrier/atmos,
/turf/open/floor/plating/asteroid,
/area/ruin/unpowered)
"bl" = (
/obj/item/holosign_creator/atmos,
/turf/open/floor/plating/asteroid/spacehermit,
/area/ruin/unpowered)
"bm" = (
/obj/machinery/power/floodlight,
/obj/structure/cable{
	icon_state = "0-2"
	},
/turf/open/floor/plating/asteroid/spacehermit,
/area/ruin/unpowered)
"bn" = (
/obj/structure/cable{
	icon_state = "1-4"
	},
/turf/open/floor/plating/asteroid/spacehermit,
/area/ruin/unpowered)
"bo" = (
/obj/structure/cable{
	icon_state = "2-8"
	},
/turf/open/floor/plating/asteroid/spacehermit,
/area/ruin/unpowered)
"bp" = (
/obj/structure/cable{
	icon_state = "1-2"
	},
/turf/open/floor/plating/asteroid/spacehermit,
/area/ruin/unpowered)
"bq" = (
/obj/item/stack/ore/iron,
/obj/item/stack/ore/iron,
/obj/item/stack/ore/iron,
/turf/open/floor/plating/asteroid/spacehermit,
/area/ruin/unpowered)
"br" = (
/obj/structure/cable,
/obj/machinery/power/port_gen/pacman{
	active = 1;
	anchored = 1;
	sheets = 10
	},
/turf/open/floor/plating/asteroid/spacehermit,
/area/ruin/unpowered)
"bs" = (
/obj/item/stack/ore/iron,
/obj/item/stack/sheet/mineral/plasma,
/obj/item/stack/sheet/mineral/plasma,
/turf/open/floor/plating/asteroid/spacehermit,
/area/ruin/unpowered)
"bt" = (
/obj/structure/fluff/empty_cryostasis_sleeper,
/obj/structure/mirror{
	pixel_x = 28
	},
/turf/open/floor/mineral/titanium,
/area/ruin/powered)
"bu" = (
/turf/closed/mineral/random/spacehermit,
/area/ruin/unpowered)

(1,1,1) = {"
aa
aa
aa
aa
aa
aa
aa
aa
aa
aa
aa
aa
aa
aa
aa
aa
aa
aa
aa
aa
aa
aa
aM
aa
aa
aa
aa
aa
aa
aa
aA
aO
aA
aA
aA
aA
aA
aa
aa
aa
aa
aa
aa
aa
aa
aa
aa
aa
aa
aa
"}
(2,1,1) = {"
aa
aa
aa
aa
aa
aa
aa
aa
aa
aa
aa
aa
aa
aa
aa
aa
aM
aa
aa
aa
aa
aa
aa
aa
aA
aA
aA
aA
aA
aA
ab
ab
ab
ab
ab
ab
ab
aA
aA
aA
aa
aa
aa
aa
aM
aa
aa
aa
aa
aa
"}
(3,1,1) = {"
aa
aa
aa
aa
aa
aa
aa
aa
aa
aa
aa
aa
aa
aa
aa
aa
aa
aa
aa
aa
aa
aA
aA
aA
ab
ab
ab
ab
ab
ab
ab
bu
bu
bu
bu
bu
ab
ab
ab
ab
aA
aA
aa
aa
aa
aa
aW
aa
aM
aa
"}
(4,1,1) = {"
aa
aa
aa
aa
aa
aa
aa
aa
aa
aa
aa
aa
aa
aa
aa
aa
aa
aa
aa
aa
aA
ab
ab
ab
ab
bu
bu
bu
bu
bu
bu
bu
bu
bu
bu
bu
bu
bu
bu
ab
ab
ab
aA
aa
aa
aV
aI
aX
aa
aa
"}
(5,1,1) = {"
aa
aa
aa
aa
aa
aa
aa
aa
aa
aa
aa
aa
aa
aa
aA
aA
aA
aA
aA
aA
ab
ab
bu
bu
bu
bu
bu
bu
bu
bu
bu
bu
bu
bu
bu
bu
bu
bu
bu
bu
bu
ab
ab
aA
aa
aa
aa
aa
aa
aa
"}
(6,1,1) = {"
aa
aa
aa
aa
aa
aa
aa
aa
aa
aa
aa
aa
aa
aA
ab
ab
ab
ab
aA
ab
ab
bu
bu
bu
bu
bu
bu
bu
bu
bu
bu
bu
bu
bu
bu
bu
bu
bu
bu
bu
bu
bu
ab
ab
aA
aa
aM
aa
aa
aa
"}
(7,1,1) = {"
aa
aa
aa
aa
aa
aa
aa
aa
aa
aa
aM
aa
aA
ab
ab
bu
bu
ab
ab
ab
bu
bu
bu
bu
bu
bu
bu
bu
bu
bu
bu
bu
bu
bu
bu
bu
bu
bu
bu
bu
bu
bu
bu
ab
ab
aA
aa
aa
aa
aa
"}
(8,1,1) = {"
aa
aa
aa
aa
aa
aa
ab
aa
aa
aa
aa
aa
aA
ab
bu
bu
bu
bu
bu
bu
bu
bu
bu
bu
bu
bu
bu
bu
bu
bu
bu
bu
bu
bu
bu
ae
af
ae
bu
bu
bu
bu
bu
bu
ab
ab
aA
aa
aa
aa
"}
(9,1,1) = {"
aa
aa
aa
aa
aA
ab
ab
aA
aa
aa
aa
aa
aA
ab
bu
bu
bu
bu
bu
bu
bu
bu
bu
bu
bu
bu
bu
bu
bu
bu
bu
bu
bu
bu
bu
af
aq
af
bu
bu
bu
bu
bu
bu
bu
ab
ab
aA
aa
aa
"}
(10,1,1) = {"
aa
aa
aa
aa
ab
ab
ab
ab
aA
aa
aa
aA
aA
ab
bu
bu
bu
bu
bu
bu
bu
bu
bu
bu
bu
bu
bu
bu
bu
bu
bu
bu
bu
bu
ae
ae
ao
ae
ae
bu
bu
bu
bu
bu
bu
bu
ab
aA
aa
aa
"}
(11,1,1) = {"
aa
aa
aa
aA
ab
ab
ab
ab
aA
aa
aa
aA
aA
ab
ab
bu
bu
bu
bu
bu
bu
bu
bu
bu
bu
bu
bu
bu
bu
bu
bu
bu
bu
bu
af
an
an
an
af
bu
bu
bu
bu
bu
bu
bu
ab
ab
aA
aa
"}
(12,1,1) = {"
aa
aa
aa
aA
ab
ab
ab
ab
aA
aa
aa
aA
aA
aA
ab
bu
bu
bu
bu
bu
bu
bu
bu
bu
bu
bu
bu
bu
bu
bu
bu
bu
bu
ae
ae
bh
an
an
ae
aZ
bu
bu
bu
bu
bu
bu
bu
ab
aA
aa
"}
(13,1,1) = {"
aa
aa
aa
aA
ab
ab
ab
ab
aA
aa
aa
aA
aA
aA
ab
bu
bu
bu
bu
bu
bu
bu
bu
bu
bu
bu
bu
bu
bu
bu
bu
bu
bu
af
aY
ao
ao
ao
ak
ba
bu
bu
bu
bu
bu
bu
bu
ab
aA
aa
"}
(14,1,1) = {"
aa
aa
aa
aa
ab
ab
ab
ab
aA
aa
aa
aA
aA
aA
ab
bu
bu
bu
bu
bu
bu
bu
bu
bu
bu
bu
bu
bu
bu
bu
bu
bu
bu
al
aj
ap
an
as
aj
aE
bu
bu
bu
bu
bu
bu
bu
ab
aA
aa
"}
(15,1,1) = {"
aa
aa
aa
aa
aA
ab
ab
aA
aa
aa
aa
aA
aA
aA
ab
bu
bu
bu
bu
bu
bu
bu
bu
bu
bu
bu
bu
bu
bu
bu
bu
bu
bu
af
bt
ao
ao
ao
bt
ba
ah
bu
bu
bu
bu
bu
bu
ab
aA
aa
"}
(16,1,1) = {"
aa
aa
aa
aa
aa
aa
ab
aa
aa
aa
aa
aA
aA
ab
ab
bu
bu
bu
bu
bu
bu
bu
ad
ax
bu
bu
bu
bu
bu
bu
bu
bu
aR
ae
ae
an
an
an
ae
aZ
ah
bu
bu
bu
bu
bu
bu
ab
aA
aM
"}
(17,1,1) = {"
aa
aa
aa
aa
aa
aa
aa
aa
aa
aa
aa
aA
aA
ab
bu
bu
bu
bu
bu
bu
bu
bu
ah
ah
bu
bu
bu
bu
bu
bu
bu
bu
aR
ag
ag
af
ar
af
at
bb
ah
bu
bu
bu
bu
bu
bu
ab
aA
aa
"}
(18,1,1) = {"
aa
aa
aa
aa
aa
aa
aa
aa
aa
aa
aa
aA
aA
ab
bu
bu
bu
bu
bu
bu
bu
ac
ah
ah
ah
ah
bu
aH
aJ
aL
bu
bu
aT
ah
ah
ah
ah
ah
ah
ah
aR
bu
bu
bu
bu
bu
bu
ab
aA
aa
"}
(19,1,1) = {"
aa
aa
aa
aa
aa
aa
aa
aa
aa
aa
aA
aA
ab
ab
bu
bu
bu
bu
bu
bu
bu
ac
am
ah
az
aD
ah
ah
ah
ah
bu
bu
ah
ah
ah
ah
ah
ah
ah
ah
bi
bu
bu
bu
bu
bu
bu
ab
aA
aa
"}
(20,1,1) = {"
aa
aa
aa
aa
aa
aa
aa
aa
aa
aa
aA
aA
ab
bu
bu
bu
bu
bu
bu
bu
bu
ac
au
ay
aB
ah
ah
ah
ah
ah
bu
bu
bu
ah
ah
ah
ah
ah
ah
ah
bu
bu
bu
bu
bu
bu
bu
ab
aA
aa
"}
(21,1,1) = {"
aa
aa
aa
aa
aa
aa
aa
aM
aa
aa
aA
aA
ab
bu
bu
bu
bu
bu
bu
bu
bu
ac
av
ah
aC
aF
ah
ah
ah
bu
bu
bu
aU
be
ah
ah
bm
bn
ah
ah
bu
bu
bu
bu
bu
bu
bu
ab
aA
aa
"}
(22,1,1) = {"
aa
aa
aa
aa
aa
aa
aa
aa
aa
aa
aA
aA
ab
bu
bu
bu
bu
bu
bu
bu
bu
ac
aw
ah
ah
ah
aG
ah
ah
bu
bu
bu
bc
bf
ah
ah
ah
bo
bp
bp
br
bu
bu
bu
bu
bu
ab
ab
aA
aa
"}
(23,1,1) = {"
aa
aa
aa
aa
aa
aa
aa
aa
aa
aa
aA
ab
ab
bu
bu
bu
bu
bu
bu
bu
bu
bu
ah
ah
ah
ah
ah
ah
ah
bu
bu
bu
bd
bg
ah
ah
ah
ah
ah
ah
bs
bu
bu
bu
bu
bu
ab
aA
aa
aa
"}
(24,1,1) = {"
aa
aa
aa
aa
aa
aa
aa
aa
aa
aA
aA
ab
bu
bu
bu
bu
bu
bu
bu
bu
bu
bu
bu
ah
bu
ah
ah
ah
ah
ah
bu
bu
ah
ah
ah
ah
ah
ah
ah
ah
ah
bu
bu
bu
bu
ab
ab
aA
aa
aa
"}
(25,1,1) = {"
aa
aa
aa
aa
aa
aa
aa
aa
aa
aA
ab
ab
bu
bu
bu
bu
bu
bu
bu
bu
bu
bu
bu
bu
bu
ah
ah
ah
ah
ah
aN
ah
ah
ah
ah
aR
ah
ah
ah
ah
bu
bu
bu
bu
bu
ab
aA
aa
aa
aa
"}
(26,1,1) = {"
aa
aa
aa
aa
aa
aa
aa
aa
aa
aA
ab
bu
bu
bu
bu
bu
bu
bu
bu
bu
bu
bu
bu
bu
bu
bu
ah
ah
ah
bu
bu
ah
ah
ah
ah
ah
ah
ah
ah
ah
ah
ah
bu
bu
ab
ab
aa
aa
aa
aa
"}
(27,1,1) = {"
aa
aa
aa
aa
aa
aa
aa
aa
aa
aA
ab
ab
bu
bu
bu
bu
bu
bu
bu
bu
bu
bu
bu
bu
bu
bu
bu
bu
aK
bu
bu
ah
ah
ah
ah
ah
ah
ah
bq
ah
ah
aR
bu
bu
ab
aA
aa
aa
aa
aM
"}
(28,1,1) = {"
aa
aa
aa
aa
aa
aa
aa
aa
aa
aa
aA
ab
bu
bu
bu
bu
bu
bu
bu
bu
bu
bu
bu
bu
bu
bu
bu
bu
bu
bu
bu
aP
ah
ah
ah
ah
ah
ah
ah
ah
ah
aR
bu
bu
ab
aA
aa
aa
aa
aa
"}
(29,1,1) = {"
aa
aa
aa
aa
aa
aa
aa
aa
aa
aa
aA
ab
bu
bu
bu
bu
bu
bu
bu
bu
bu
bu
bu
bu
bu
bu
bu
bu
bu
bu
bu
aQ
aP
ah
ah
aR
ah
ah
ah
ah
bu
ah
bu
bu
ab
aA
aa
aa
aa
aa
"}
(30,1,1) = {"
aa
aa
aa
aa
aa
aa
aa
aa
aa
aa
aA
ab
bu
bu
bu
bu
bu
bu
bu
bu
bu
bu
bu
bu
bu
bu
bu
bu
bu
bu
bu
bu
bu
ah
ah
ah
ah
aP
ah
bi
bu
bu
bu
ab
ab
aa
aa
aa
aa
aa
"}
(31,1,1) = {"
aa
aa
aa
aa
aa
aa
aa
aa
aa
aa
aA
ab
ab
ab
bu
bu
bu
bu
bu
bu
bu
bu
bu
bu
bu
bu
bu
bu
bu
bu
bu
bu
bu
ah
ah
ah
ah
ah
ah
aS
bu
bu
bu
ab
aA
aa
aa
aa
ab
aA
"}
(32,1,1) = {"
aa
aa
aa
aa
aa
aa
aa
aa
aa
aa
aa
aA
aA
ab
bu
bu
bu
bu
bu
bu
bu
bu
bu
bu
bu
bu
bu
bu
bu
bu
bu
bu
bu
bi
ah
ah
ah
ah
ah
aS
bu
bu
bu
ab
aA
aa
aa
aO
ab
ab
"}
(33,1,1) = {"
aa
aa
aa
aa
aa
aa
aa
aa
aa
aa
aa
aa
aA
ab
ab
bu
bu
bu
bu
bu
bu
bu
bu
bu
bu
bu
bu
bu
bu
bu
bu
bu
bu
ah
ah
bl
ah
ah
ah
aS
bu
bu
bu
ab
aA
aa
aA
ab
ab
ab
"}
(34,1,1) = {"
aa
aa
aa
aa
aa
aa
aa
aa
aa
aa
aa
aa
aa
aA
ab
ab
bu
bu
bu
bu
bu
bu
bu
bu
bu
bu
bu
bu
bu
bu
bu
bu
ab
aS
bj
ah
ah
ah
aS
aS
bu
bu
ab
ab
aA
aa
aA
ab
ab
aA
"}
(35,1,1) = {"
aa
aa
aa
aa
aa
aa
aA
aA
aa
aa
aa
aa
aM
aa
aA
ab
bu
bu
bu
bu
bu
bu
bu
bu
bu
bu
bu
bu
bu
bu
ab
ab
ab
aS
ah
ah
ah
ah
aS
aS
bu
bu
ab
aA
aa
aa
aA
ab
ab
ab
"}
(36,1,1) = {"
aa
aa
aa
aa
aa
aa
ab
ab
aA
aa
aa
aa
aa
aa
aA
ab
ab
bu
bu
bu
bu
bu
bu
bu
bu
bu
bu
bu
bu
ab
ab
aA
aS
aS
aS
bk
bk
aS
aS
aS
aS
ab
ab
aA
aa
aa
aa
ab
ab
ab
"}
(37,1,1) = {"
aa
aa
aa
aa
aa
ab
ab
ab
ab
aa
aa
aa
aa
aa
aA
aA
ab
ab
bu
bu
bu
bu
bu
bu
bu
bu
bu
bu
bu
ab
aA
aA
aA
aS
aS
aS
bk
aS
aS
aS
aA
aA
ab
aA
aa
aa
aa
aa
aA
aA
"}
(38,1,1) = {"
aa
aa
aa
aa
aa
ab
ab
ab
ab
ab
aa
aa
aa
aa
aa
aA
aA
ab
ab
bu
bu
bu
bu
bu
bu
bu
bu
bu
bu
ab
aA
aA
ai
ai
ai
ai
ai
ai
ai
ai
aA
aA
ab
aA
aa
aa
aa
aa
aa
aa
"}
(39,1,1) = {"
aa
aa
aa
aa
aa
aA
ab
ab
ab
ab
aa
aa
aa
aa
aa
aa
aA
aA
ab
ab
bu
bu
bu
bu
bu
bu
bu
bu
bu
ab
aA
aa
aa
aa
ai
ai
ai
aa
ai
aa
aa
aA
ab
aA
aa
aa
aa
aa
aa
aa
"}
(40,1,1) = {"
aa
aa
aa
aa
aa
aa
aA
ab
ab
aA
aa
aa
aa
aa
aa
aa
aa
aA
aA
ab
ab
bu
bu
bu
bu
bu
bu
bu
bu
ab
ab
ab
aa
aa
aa
aa
aa
aa
ai
aa
aa
ab
ab
aA
aa
aa
aa
aa
aa
aa
"}
(41,1,1) = {"
aa
aa
aa
aa
aa
aa
aa
aa
aa
aa
aa
aa
aa
aa
aa
aa
aa
aa
aA
aA
ab
ab
ab
ab
ab
ab
ab
ab
ab
ab
ab
ab
aa
aa
aa
aa
aa
aa
aa
aa
aa
ab
ab
aA
aa
aa
aa
aa
aa
aa
"}
(42,1,1) = {"
aa
aa
aa
aa
aa
aa
aa
aa
aa
aa
aa
aa
aa
aa
aa
aa
aa
aa
aa
aA
aA
aA
aA
aA
aA
aA
aA
aA
ab
ab
ab
ab
ab
aa
aa
aa
aa
aa
aa
aa
aa
ab
aa
aa
aa
aa
aM
aa
aa
aa
"}
(43,1,1) = {"
aa
aa
aa
aa
aa
aa
aa
aa
aa
aa
aa
aa
aa
aa
aa
aa
aa
aa
aa
aa
aa
aa
aa
aa
aa
aa
aa
aA
aA
aA
aA
aA
ab
aa
aa
aa
aa
aa
aa
aa
aa
aa
aa
aa
aa
aa
aa
aa
aa
aa
"}
(44,1,1) = {"
aa
aa
aa
aa
aa
aa
aa
aa
aa
aa
aa
aa
aa
aa
aa
aa
aa
aa
aa
aa
aa
aa
aa
aa
aa
aa
aa
aa
aa
aa
aa
aa
aa
aa
aa
aa
aa
aa
aa
aa
aa
aa
aa
aa
aa
aa
aA
aa
aa
aa
"}
(45,1,1) = {"
aa
aa
aa
aa
aa
aa
aa
aa
aa
aa
aa
aa
aa
aa
aA
aa
aa
aa
aa
aM
aa
aa
aa
aa
aa
aa
aa
aM
aa
aa
aa
aa
aa
aa
aa
aa
aa
aa
aa
aa
aM
aa
aa
aa
aa
aA
ab
aA
aa
aa
"}
(46,1,1) = {"
aa
aa
aa
aa
aa
aa
aa
aa
aa
aa
aa
aa
aa
aM
ab
ab
aA
aa
aa
aa
aa
aa
aa
aa
aa
aa
aa
aa
aa
aa
aa
aa
aa
aa
aa
aa
aa
aa
aa
aa
aa
aa
aa
aa
aa
ab
ab
ab
aa
aa
"}
(47,1,1) = {"
aa
aa
aa
aa
aa
aa
aa
aa
aa
aa
aa
aa
aa
ab
ab
ab
ab
aA
aa
aa
aa
aa
aa
aa
aa
aa
aa
aa
aa
aa
aa
aa
aA
aA
aa
aa
aa
aa
aa
aa
aa
aa
aa
aa
aa
ab
ab
ab
aa
aa
"}
(48,1,1) = {"
aa
aa
aa
aa
aa
aa
aa
aa
aa
aa
aa
aa
aa
aA
ab
ab
ab
ab
aa
aa
aa
aM
aa
aa
aa
aa
aa
aa
aa
aa
aa
aA
ab
aA
aa
aa
aa
aa
aa
aa
aa
aa
aa
aa
aa
aA
ab
aA
aa
aa
"}
(49,1,1) = {"
aa
aa
aa
aa
aa
aa
aa
aa
aa
aa
aa
aa
aa
aa
aa
aA
aA
aa
aa
aa
aa
aa
aa
aa
aa
aa
aa
aa
aa
aa
aa
aa
aA
aa
aa
aa
aa
aM
aa
aa
aa
aa
aa
aa
aa
aA
aa
aa
aa
aa
"}
(50,1,1) = {"
aa
aa
aa
aa
aa
aa
aa
aa
aa
aa
aa
aa
aa
aa
aa
aa
aa
aa
aa
aa
aa
aa
aa
aa
aa
aa
aa
aa
aa
aa
aa
aa
aa
aa
aa
aa
aa
aa
aa
aa
aa
aa
aa
aa
aa
ab
aa
aa
aa
aa
"}
