//MAP CONVERTED BY dmm2tgm.py THIS HEADER COMMENT PREVENTS RECONVERSION, DO NOT REMOVE
"a" = (
/turf/open/space/basic,
/area/space)
"f" = (
/obj/structure/fans/tiny/invisible,
/turf/open/floor/fakepit,
/area/ruin/space/has_grav/powered/wiz_home)
"h" = (
/obj/structure/bed,
/obj/item/bedsheet/wiz,
/obj/machinery/light_switch{
	pixel_y = -24
	},
/turf/open/floor/wood,
/area/ruin/space/has_grav/powered/wiz_home)
"j" = (
/obj/structure/table/wood,
/obj/item/book/codex_gigas,
/obj/machinery/light{
	dir = 8
	},
/turf/open/floor/wood,
/area/ruin/space/has_grav/powered/wiz_home)
"p" = (
/obj/machinery/door/airlock/external,
/obj/effect/mapping_helpers/airlock/cyclelink_helper,
/turf/open/floor/plating,
/area/ruin/space/has_grav/powered/wiz_home)
"t" = (
/obj/structure/table/wood,
/obj/item/gun/magic/staff/healing{
	attack_verb = list("struck","hit","bashed", "bonked");
	can_charge = 0;
	desc = "The famous Staff of Revival toted by wizards. Supposedly able to heal all ailments, and even revive the dead. This one has the name 'Chloe' etched on the side. It feels cold.";
	max_charges = 0;
	name = "Chloe's staff of healing";
	recharge_rate = 0
	},
/turf/open/floor/wood,
/area/ruin/space/has_grav/powered/wiz_home)
"v" = (
/obj/structure/destructible/cult/tome,
/turf/open/floor/wood,
/area/ruin/space/has_grav/powered/wiz_home)
"w" = (
/turf/closed/indestructible/wood,
/area/ruin/space/has_grav/powered/wiz_home)
"y" = (
/turf/open/floor/carpet,
/area/ruin/space/has_grav/powered/wiz_home)
"z" = (
/obj/structure/table/wood,
/obj/item/storage/pill_bottle/dice{
	icon_state = "magicdicebag"
	},
/turf/open/floor/wood,
/area/ruin/space/has_grav/powered/wiz_home)
"B" = (
/obj/structure/chair/wood/wings{
	dir = 1
	},
/turf/open/floor/carpet,
/area/ruin/space/has_grav/powered/wiz_home)
"G" = (
/obj/structure/showcase{
	desc = "A historical figure of great importance to the wizard federation. He spent his long life learning magic, stealing artifacts, and harassing idiots with swords. May he rest forever, Rodney.";
	icon = 'icons/mob/mob.dmi';
	icon_state = "nim";
	name = "wizard of yendor showcase"
	},
/turf/open/floor/wood,
/area/ruin/space/has_grav/powered/wiz_home)
"I" = (
/obj/machinery/vending/magivend_novirus,
/obj/item/storage/backpack/satchel/flat/secret/chloe_ruin,
/turf/open/floor/wood,
/area/ruin/space/has_grav/powered/wiz_home)
"K" = (
/obj/item/clothing/shoes/sandal/marisa,
/obj/item/clothing/suit/wizrobe/marisa,
/obj/item/clothing/head/wizard/marisa,
/obj/effect/decal/remains/human,
/turf/open/floor/carpet,
/area/ruin/space/has_grav/powered/wiz_home)
"P" = (
/obj/structure/table/wood,
/obj/item/book/granter/spell/smoke,
/turf/open/floor/wood,
/area/ruin/space/has_grav/powered/wiz_home)
"S" = (
/obj/machinery/light,
/turf/open/floor/wood,
/area/ruin/space/has_grav/powered/wiz_home)
"U" = (
/obj/machinery/light{
	dir = 4
	},
/turf/open/floor/wood,
/area/ruin/space/has_grav/powered/wiz_home)
"V" = (
/turf/open/floor/wood,
/area/ruin/space/has_grav/powered/wiz_home)
"W" = (
/obj/structure/destructible/cult/talisman{
	desc = "An altar dedicated to the Wizards' Federation"
	},
/obj/item/kitchen/knife/ritual,
/turf/open/floor/wood,
/area/ruin/space/has_grav/powered/wiz_home)
"X" = (
/obj/structure/table/wood,
/obj/item/spellbook{
	name = "Magical Grimoire";
	owner = "Chloe Zadovsky";
	uses = 0
	},
/turf/open/floor/wood,
/area/ruin/space/has_grav/powered/wiz_home)
"Y" = (
/obj/machinery/door/airlock/external,
/obj/effect/mapping_helpers/airlock/cyclelink_helper{
	dir = 1
	},
/turf/open/floor/plating,
/area/ruin/space/has_grav/powered/wiz_home)

(1,1,1) = {"
a
a
a
a
a
a
a
a
a
a
a
a
a
a
a
"}
(2,1,1) = {"
a
a
a
a
a
a
a
a
a
a
a
a
a
a
a
"}
(3,1,1) = {"
a
a
w
w
w
w
w
w
a
a
a
a
a
a
a
"}
(4,1,1) = {"
a
a
w
z
X
j
V
w
a
a
a
a
a
a
a
"}
(5,1,1) = {"
a
a
w
t
K
y
V
w
a
a
a
a
a
a
a
"}
(6,1,1) = {"
a
a
w
P
y
y
V
w
a
a
a
a
a
a
a
"}
(7,1,1) = {"
a
a
w
v
B
y
h
w
a
a
a
a
a
a
a
"}
(8,1,1) = {"
a
a
w
W
y
y
G
w
a
a
a
a
a
a
a
"}
(9,1,1) = {"
a
a
w
V
y
y
S
w
w
w
a
a
a
a
a
"}
(10,1,1) = {"
a
a
w
V
y
y
V
p
f
Y
a
a
a
a
a
"}
(11,1,1) = {"
a
a
w
I
V
U
V
w
w
w
a
a
a
a
a
"}
(12,1,1) = {"
a
a
w
w
w
w
w
w
a
a
a
a
a
a
a
"}
(13,1,1) = {"
a
a
a
a
a
a
a
a
a
a
a
a
a
a
a
"}
(14,1,1) = {"
a
a
a
a
a
a
a
a
a
a
a
a
a
a
a
"}
(15,1,1) = {"
a
a
a
a
a
a
a
a
a
a
a
a
a
a
a
"}

(1,1,2) = {"
a
a
a
a
a
a
a
a
a
a
a
a
a
a
a
"}
(2,1,2) = {"
a
a
a
a
a
a
a
a
a
a
a
a
a
a
a
"}
(3,1,2) = {"
a
a
a
a
a
a
a
a
a
a
a
a
a
a
a
"}
(4,1,2) = {"
a
a
a
a
a
a
a
a
a
a
a
a
a
a
a
"}
(5,1,2) = {"
a
a
a
a
a
a
a
a
a
a
a
a
a
a
a
"}
(6,1,2) = {"
a
a
a
a
a
a
a
a
a
a
a
a
a
a
a
"}
(7,1,2) = {"
a
a
a
a
a
a
a
a
a
a
a
a
a
a
a
"}
(8,1,2) = {"
a
a
a
a
a
a
a
a
a
a
a
a
a
a
a
"}
(9,1,2) = {"
a
a
a
a
a
a
a
a
a
a
a
a
a
a
a
"}
(10,1,2) = {"
a
a
a
a
a
a
a
a
a
a
a
a
a
a
a
"}
(11,1,2) = {"
a
a
a
a
a
a
a
a
a
a
a
a
a
a
a
"}
(12,1,2) = {"
a
a
a
a
a
a
a
a
a
a
a
a
a
a
a
"}
(13,1,2) = {"
a
a
a
a
a
a
a
a
a
a
a
a
a
a
a
"}
(14,1,2) = {"
a
a
a
a
a
a
a
a
a
a
a
a
a
a
a
"}
(15,1,2) = {"
a
a
a
a
a
a
a
a
a
a
a
a
a
a
a
"}

(1,1,3) = {"
a
a
a
a
a
a
a
a
a
a
a
a
a
a
a
"}
(2,1,3) = {"
a
a
a
a
a
a
a
a
a
a
a
a
a
a
a
"}
(3,1,3) = {"
a
a
a
a
a
a
a
a
a
a
a
a
a
a
a
"}
(4,1,3) = {"
a
a
a
a
a
a
a
a
a
a
a
a
a
a
a
"}
(5,1,3) = {"
a
a
a
a
a
a
a
a
a
a
a
a
a
a
a
"}
(6,1,3) = {"
a
a
a
a
a
a
a
a
a
a
a
a
a
a
a
"}
(7,1,3) = {"
a
a
a
a
a
a
a
a
a
a
a
a
a
a
a
"}
(8,1,3) = {"
a
a
a
a
a
a
a
a
a
a
a
a
a
a
a
"}
(9,1,3) = {"
a
a
a
a
a
a
a
a
a
a
a
a
a
a
a
"}
(10,1,3) = {"
a
a
a
a
a
a
a
a
a
a
a
a
a
a
a
"}
(11,1,3) = {"
a
a
a
a
a
a
a
a
a
a
a
a
a
a
a
"}
(12,1,3) = {"
a
a
a
a
a
a
a
a
a
a
a
a
a
a
a
"}
(13,1,3) = {"
a
a
a
a
a
a
a
a
a
a
a
a
a
a
a
"}
(14,1,3) = {"
a
a
a
a
a
a
a
a
a
a
a
a
a
a
a
"}
(15,1,3) = {"
a
a
a
a
a
a
a
a
a
a
a
a
a
a
a
"}

(1,1,4) = {"
a
a
a
a
a
a
a
a
a
a
a
a
a
a
a
"}
(2,1,4) = {"
a
a
a
a
a
a
a
a
a
a
a
a
a
a
a
"}
(3,1,4) = {"
a
a
a
a
a
a
a
a
a
a
a
a
a
a
a
"}
(4,1,4) = {"
a
a
a
a
a
a
a
a
a
a
a
a
a
a
a
"}
(5,1,4) = {"
a
a
a
a
a
a
a
a
a
a
a
a
a
a
a
"}
(6,1,4) = {"
a
a
a
a
a
a
a
a
a
a
a
a
a
a
a
"}
(7,1,4) = {"
a
a
a
a
a
a
a
a
a
a
a
a
a
a
a
"}
(8,1,4) = {"
a
a
a
a
a
a
a
a
a
a
a
a
a
a
a
"}
(9,1,4) = {"
a
a
a
a
a
a
a
a
a
a
a
a
a
a
a
"}
(10,1,4) = {"
a
a
a
a
a
a
a
a
a
a
a
a
a
a
a
"}
(11,1,4) = {"
a
a
a
a
a
a
a
a
a
a
a
a
a
a
a
"}
(12,1,4) = {"
a
a
a
a
a
a
a
a
a
a
a
a
a
a
a
"}
(13,1,4) = {"
a
a
a
a
a
a
a
a
a
a
a
a
a
a
a
"}
(14,1,4) = {"
a
a
a
a
a
a
a
a
a
a
a
a
a
a
a
"}
(15,1,4) = {"
a
a
a
a
a
a
a
a
a
a
a
a
a
a
a
"}

(1,1,5) = {"
a
a
a
a
a
a
a
a
a
a
a
a
a
a
a
"}
(2,1,5) = {"
a
a
a
a
a
a
a
a
a
a
a
a
a
a
a
"}
(3,1,5) = {"
a
a
a
a
a
a
a
a
a
a
a
a
a
a
a
"}
(4,1,5) = {"
a
a
a
a
a
a
a
a
a
a
a
a
a
a
a
"}
(5,1,5) = {"
a
a
a
a
a
a
a
a
a
a
a
a
a
a
a
"}
(6,1,5) = {"
a
a
a
a
a
a
a
a
a
a
a
a
a
a
a
"}
(7,1,5) = {"
a
a
a
a
a
a
a
a
a
a
a
a
a
a
a
"}
(8,1,5) = {"
a
a
a
a
a
a
a
a
a
a
a
a
a
a
a
"}
(9,1,5) = {"
a
a
a
a
a
a
a
a
a
a
a
a
a
a
a
"}
(10,1,5) = {"
a
a
a
a
a
a
a
a
a
a
a
a
a
a
a
"}
(11,1,5) = {"
a
a
a
a
a
a
a
a
a
a
a
a
a
a
a
"}
(12,1,5) = {"
a
a
a
a
a
a
a
a
a
a
a
a
a
a
a
"}
(13,1,5) = {"
a
a
a
a
a
a
a
a
a
a
a
a
a
a
a
"}
(14,1,5) = {"
a
a
a
a
a
a
a
a
a
a
a
a
a
a
a
"}
(15,1,5) = {"
a
a
a
a
a
a
a
a
a
a
a
a
a
a
a
"}

(1,1,6) = {"
a
a
a
a
a
a
a
a
a
a
a
a
a
a
a
"}
(2,1,6) = {"
a
a
a
a
a
a
a
a
a
a
a
a
a
a
a
"}
(3,1,6) = {"
a
a
a
a
a
a
a
a
a
a
a
a
a
a
a
"}
(4,1,6) = {"
a
a
a
a
a
a
a
a
a
a
a
a
a
a
a
"}
(5,1,6) = {"
a
a
a
a
a
a
a
a
a
a
a
a
a
a
a
"}
(6,1,6) = {"
a
a
a
a
a
a
a
a
a
a
a
a
a
a
a
"}
(7,1,6) = {"
a
a
a
a
a
a
a
a
a
a
a
a
a
a
a
"}
(8,1,6) = {"
a
a
a
a
a
a
a
a
a
a
a
a
a
a
a
"}
(9,1,6) = {"
a
a
a
a
a
a
a
a
a
a
a
a
a
a
a
"}
(10,1,6) = {"
a
a
a
a
a
a
a
a
a
a
a
a
a
a
a
"}
(11,1,6) = {"
a
a
a
a
a
a
a
a
a
a
a
a
a
a
a
"}
(12,1,6) = {"
a
a
a
a
a
a
a
a
a
a
a
a
a
a
a
"}
(13,1,6) = {"
a
a
a
a
a
a
a
a
a
a
a
a
a
a
a
"}
(14,1,6) = {"
a
a
a
a
a
a
a
a
a
a
a
a
a
a
a
"}
(15,1,6) = {"
a
a
a
a
a
a
a
a
a
a
a
a
a
a
a
"}

(1,1,7) = {"
a
a
a
a
a
a
a
a
a
a
a
a
a
a
a
"}
(2,1,7) = {"
a
a
a
a
a
a
a
a
a
a
a
a
a
a
a
"}
(3,1,7) = {"
a
a
a
a
a
a
a
a
a
a
a
a
a
a
a
"}
(4,1,7) = {"
a
a
a
a
a
a
a
a
a
a
a
a
a
a
a
"}
(5,1,7) = {"
a
a
a
a
a
a
a
a
a
a
a
a
a
a
a
"}
(6,1,7) = {"
a
a
a
a
a
a
a
a
a
a
a
a
a
a
a
"}
(7,1,7) = {"
a
a
a
a
a
a
a
a
a
a
a
a
a
a
a
"}
(8,1,7) = {"
a
a
a
a
a
a
a
a
a
a
a
a
a
a
a
"}
(9,1,7) = {"
a
a
a
a
a
a
a
a
a
a
a
a
a
a
a
"}
(10,1,7) = {"
a
a
a
a
a
a
a
a
a
a
a
a
a
a
a
"}
(11,1,7) = {"
a
a
a
a
a
a
a
a
a
a
a
a
a
a
a
"}
(12,1,7) = {"
a
a
a
a
a
a
a
a
a
a
a
a
a
a
a
"}
(13,1,7) = {"
a
a
a
a
a
a
a
a
a
a
a
a
a
a
a
"}
(14,1,7) = {"
a
a
a
a
a
a
a
a
a
a
a
a
a
a
a
"}
(15,1,7) = {"
a
a
a
a
a
a
a
a
a
a
a
a
a
a
a
"}

(1,1,8) = {"
a
a
a
a
a
a
a
a
a
a
a
a
a
a
a
"}
(2,1,8) = {"
a
a
a
a
a
a
a
a
a
a
a
a
a
a
a
"}
(3,1,8) = {"
a
a
a
a
a
a
a
a
a
a
a
a
a
a
a
"}
(4,1,8) = {"
a
a
a
a
a
a
a
a
a
a
a
a
a
a
a
"}
(5,1,8) = {"
a
a
a
a
a
a
a
a
a
a
a
a
a
a
a
"}
(6,1,8) = {"
a
a
a
a
a
a
a
a
a
a
a
a
a
a
a
"}
(7,1,8) = {"
a
a
a
a
a
a
a
a
a
a
a
a
a
a
a
"}
(8,1,8) = {"
a
a
a
a
a
a
a
a
a
a
a
a
a
a
a
"}
(9,1,8) = {"
a
a
a
a
a
a
a
a
a
a
a
a
a
a
a
"}
(10,1,8) = {"
a
a
a
a
a
a
a
a
a
a
a
a
a
a
a
"}
(11,1,8) = {"
a
a
a
a
a
a
a
a
a
a
a
a
a
a
a
"}
(12,1,8) = {"
a
a
a
a
a
a
a
a
a
a
a
a
a
a
a
"}
(13,1,8) = {"
a
a
a
a
a
a
a
a
a
a
a
a
a
a
a
"}
(14,1,8) = {"
a
a
a
a
a
a
a
a
a
a
a
a
a
a
a
"}
(15,1,8) = {"
a
a
a
a
a
a
a
a
a
a
a
a
a
a
a
"}

(1,1,9) = {"
a
a
a
a
a
a
a
a
a
a
a
a
a
a
a
"}
(2,1,9) = {"
a
a
a
a
a
a
a
a
a
a
a
a
a
a
a
"}
(3,1,9) = {"
a
a
a
a
a
a
a
a
a
a
a
a
a
a
a
"}
(4,1,9) = {"
a
a
a
a
a
a
a
a
a
a
a
a
a
a
a
"}
(5,1,9) = {"
a
a
a
a
a
a
a
a
a
a
a
a
a
a
a
"}
(6,1,9) = {"
a
a
a
a
a
a
a
a
a
a
a
a
a
a
a
"}
(7,1,9) = {"
a
a
a
a
a
a
a
a
a
a
a
a
a
a
a
"}
(8,1,9) = {"
a
a
a
a
a
a
a
a
a
a
a
a
a
a
a
"}
(9,1,9) = {"
a
a
a
a
a
a
a
a
a
a
a
a
a
a
a
"}
(10,1,9) = {"
a
a
a
a
a
a
a
a
a
a
a
a
a
a
a
"}
(11,1,9) = {"
a
a
a
a
a
a
a
a
a
a
a
a
a
a
a
"}
(12,1,9) = {"
a
a
a
a
a
a
a
a
a
a
a
a
a
a
a
"}
(13,1,9) = {"
a
a
a
a
a
a
a
a
a
a
a
a
a
a
a
"}
(14,1,9) = {"
a
a
a
a
a
a
a
a
a
a
a
a
a
a
a
"}
(15,1,9) = {"
a
a
a
a
a
a
a
a
a
a
a
a
a
a
a
"}

(1,1,10) = {"
a
a
a
a
a
a
a
a
a
a
a
a
a
a
a
"}
(2,1,10) = {"
a
a
a
a
a
a
a
a
a
a
a
a
a
a
a
"}
(3,1,10) = {"
a
a
a
a
a
a
a
a
a
a
a
a
a
a
a
"}
(4,1,10) = {"
a
a
a
a
a
a
a
a
a
a
a
a
a
a
a
"}
(5,1,10) = {"
a
a
a
a
a
a
a
a
a
a
a
a
a
a
a
"}
(6,1,10) = {"
a
a
a
a
a
a
a
a
a
a
a
a
a
a
a
"}
(7,1,10) = {"
a
a
a
a
a
a
a
a
a
a
a
a
a
a
a
"}
(8,1,10) = {"
a
a
a
a
a
a
a
a
a
a
a
a
a
a
a
"}
(9,1,10) = {"
a
a
a
a
a
a
a
a
a
a
a
a
a
a
a
"}
(10,1,10) = {"
a
a
a
a
a
a
a
a
a
a
a
a
a
a
a
"}
(11,1,10) = {"
a
a
a
a
a
a
a
a
a
a
a
a
a
a
a
"}
(12,1,10) = {"
a
a
a
a
a
a
a
a
a
a
a
a
a
a
a
"}
(13,1,10) = {"
a
a
a
a
a
a
a
a
a
a
a
a
a
a
a
"}
(14,1,10) = {"
a
a
a
a
a
a
a
a
a
a
a
a
a
a
a
"}
(15,1,10) = {"
a
a
a
a
a
a
a
a
a
a
a
a
a
a
a
"}

(1,1,11) = {"
a
a
a
a
a
a
a
a
a
a
a
a
a
a
a
"}
(2,1,11) = {"
a
a
a
a
a
a
a
a
a
a
a
a
a
a
a
"}
(3,1,11) = {"
a
a
a
a
a
a
a
a
a
a
a
a
a
a
a
"}
(4,1,11) = {"
a
a
a
a
a
a
a
a
a
a
a
a
a
a
a
"}
(5,1,11) = {"
a
a
a
a
a
a
a
a
a
a
a
a
a
a
a
"}
(6,1,11) = {"
a
a
a
a
a
a
a
a
a
a
a
a
a
a
a
"}
(7,1,11) = {"
a
a
a
a
a
a
a
a
a
a
a
a
a
a
a
"}
(8,1,11) = {"
a
a
a
a
a
a
a
a
a
a
a
a
a
a
a
"}
(9,1,11) = {"
a
a
a
a
a
a
a
a
a
a
a
a
a
a
a
"}
(10,1,11) = {"
a
a
a
a
a
a
a
a
a
a
a
a
a
a
a
"}
(11,1,11) = {"
a
a
a
a
a
a
a
a
a
a
a
a
a
a
a
"}
(12,1,11) = {"
a
a
a
a
a
a
a
a
a
a
a
a
a
a
a
"}
(13,1,11) = {"
a
a
a
a
a
a
a
a
a
a
a
a
a
a
a
"}
(14,1,11) = {"
a
a
a
a
a
a
a
a
a
a
a
a
a
a
a
"}
(15,1,11) = {"
a
a
a
a
a
a
a
a
a
a
a
a
a
a
a
"}

(1,1,12) = {"
a
a
a
a
a
a
a
a
a
a
a
a
a
a
a
"}
(2,1,12) = {"
a
a
a
a
a
a
a
a
a
a
a
a
a
a
a
"}
(3,1,12) = {"
a
a
a
a
a
a
a
a
a
a
a
a
a
a
a
"}
(4,1,12) = {"
a
a
a
a
a
a
a
a
a
a
a
a
a
a
a
"}
(5,1,12) = {"
a
a
a
a
a
a
a
a
a
a
a
a
a
a
a
"}
(6,1,12) = {"
a
a
a
a
a
a
a
a
a
a
a
a
a
a
a
"}
(7,1,12) = {"
a
a
a
a
a
a
a
a
a
a
a
a
a
a
a
"}
(8,1,12) = {"
a
a
a
a
a
a
a
a
a
a
a
a
a
a
a
"}
(9,1,12) = {"
a
a
a
a
a
a
a
a
a
a
a
a
a
a
a
"}
(10,1,12) = {"
a
a
a
a
a
a
a
a
a
a
a
a
a
a
a
"}
(11,1,12) = {"
a
a
a
a
a
a
a
a
a
a
a
a
a
a
a
"}
(12,1,12) = {"
a
a
a
a
a
a
a
a
a
a
a
a
a
a
a
"}
(13,1,12) = {"
a
a
a
a
a
a
a
a
a
a
a
a
a
a
a
"}
(14,1,12) = {"
a
a
a
a
a
a
a
a
a
a
a
a
a
a
a
"}
(15,1,12) = {"
a
a
a
a
a
a
a
a
a
a
a
a
a
a
a
"}

(1,1,13) = {"
a
a
a
a
a
a
a
a
a
a
a
a
a
a
a
"}
(2,1,13) = {"
a
a
a
a
a
a
a
a
a
a
a
a
a
a
a
"}
(3,1,13) = {"
a
a
a
a
a
a
a
a
a
a
a
a
a
a
a
"}
(4,1,13) = {"
a
a
a
a
a
a
a
a
a
a
a
a
a
a
a
"}
(5,1,13) = {"
a
a
a
a
a
a
a
a
a
a
a
a
a
a
a
"}
(6,1,13) = {"
a
a
a
a
a
a
a
a
a
a
a
a
a
a
a
"}
(7,1,13) = {"
a
a
a
a
a
a
a
a
a
a
a
a
a
a
a
"}
(8,1,13) = {"
a
a
a
a
a
a
a
a
a
a
a
a
a
a
a
"}
(9,1,13) = {"
a
a
a
a
a
a
a
a
a
a
a
a
a
a
a
"}
(10,1,13) = {"
a
a
a
a
a
a
a
a
a
a
a
a
a
a
a
"}
(11,1,13) = {"
a
a
a
a
a
a
a
a
a
a
a
a
a
a
a
"}
(12,1,13) = {"
a
a
a
a
a
a
a
a
a
a
a
a
a
a
a
"}
(13,1,13) = {"
a
a
a
a
a
a
a
a
a
a
a
a
a
a
a
"}
(14,1,13) = {"
a
a
a
a
a
a
a
a
a
a
a
a
a
a
a
"}
(15,1,13) = {"
a
a
a
a
a
a
a
a
a
a
a
a
a
a
a
"}

(1,1,14) = {"
a
a
a
a
a
a
a
a
a
a
a
a
a
a
a
"}
(2,1,14) = {"
a
a
a
a
a
a
a
a
a
a
a
a
a
a
a
"}
(3,1,14) = {"
a
a
a
a
a
a
a
a
a
a
a
a
a
a
a
"}
(4,1,14) = {"
a
a
a
a
a
a
a
a
a
a
a
a
a
a
a
"}
(5,1,14) = {"
a
a
a
a
a
a
a
a
a
a
a
a
a
a
a
"}
(6,1,14) = {"
a
a
a
a
a
a
a
a
a
a
a
a
a
a
a
"}
(7,1,14) = {"
a
a
a
a
a
a
a
a
a
a
a
a
a
a
a
"}
(8,1,14) = {"
a
a
a
a
a
a
a
a
a
a
a
a
a
a
a
"}
(9,1,14) = {"
a
a
a
a
a
a
a
a
a
a
a
a
a
a
a
"}
(10,1,14) = {"
a
a
a
a
a
a
a
a
a
a
a
a
a
a
a
"}
(11,1,14) = {"
a
a
a
a
a
a
a
a
a
a
a
a
a
a
a
"}
(12,1,14) = {"
a
a
a
a
a
a
a
a
a
a
a
a
a
a
a
"}
(13,1,14) = {"
a
a
a
a
a
a
a
a
a
a
a
a
a
a
a
"}
(14,1,14) = {"
a
a
a
a
a
a
a
a
a
a
a
a
a
a
a
"}
(15,1,14) = {"
a
a
a
a
a
a
a
a
a
a
a
a
a
a
a
"}

(1,1,15) = {"
a
a
a
a
a
a
a
a
a
a
a
a
a
a
a
"}
(2,1,15) = {"
a
a
a
a
a
a
a
a
a
a
a
a
a
a
a
"}
(3,1,15) = {"
a
a
a
a
a
a
a
a
a
a
a
a
a
a
a
"}
(4,1,15) = {"
a
a
a
a
a
a
a
a
a
a
a
a
a
a
a
"}
(5,1,15) = {"
a
a
a
a
a
a
a
a
a
a
a
a
a
a
a
"}
(6,1,15) = {"
a
a
a
a
a
a
a
a
a
a
a
a
a
a
a
"}
(7,1,15) = {"
a
a
a
a
a
a
a
a
a
a
a
a
a
a
a
"}
(8,1,15) = {"
a
a
a
a
a
a
a
a
a
a
a
a
a
a
a
"}
(9,1,15) = {"
a
a
a
a
a
a
a
a
a
a
a
a
a
a
a
"}
(10,1,15) = {"
a
a
a
a
a
a
a
a
a
a
a
a
a
a
a
"}
(11,1,15) = {"
a
a
a
a
a
a
a
a
a
a
a
a
a
a
a
"}
(12,1,15) = {"
a
a
a
a
a
a
a
a
a
a
a
a
a
a
a
"}
(13,1,15) = {"
a
a
a
a
a
a
a
a
a
a
a
a
a
a
a
"}
(14,1,15) = {"
a
a
a
a
a
a
a
a
a
a
a
a
a
a
a
"}
(15,1,15) = {"
a
a
a
a
a
a
a
a
a
a
a
a
a
a
a
"}
