//MAP CONVERTED BY dmm2tgm.py THIS HEADER COMMENT PREVENTS RECONVERSION, DO NOT REMOVE
"cn" = (
/turf/closed/wall/mineral/titanium/custom/window/arrivals{
	icon_state = "arrivals22"
	},
/area/shuttle/arrival)
"cw" = (
/turf/closed/wall/mineral/titanium/custom/window/arrivals{
	icon_state = "arrivals38"
	},
/area/shuttle/arrival)
"cO" = (
/turf/closed/wall/mineral/titanium/custom/window/arrivals{
	icon_state = "arrivals29"
	},
/area/shuttle/arrival)
"de" = (
/turf/closed/wall/mineral/titanium/custom/window/arrivals{
	icon_state = "arrivals33"
	},
/area/shuttle/arrival)
"dO" = (
/turf/closed/wall/mineral/titanium/custom/arrivals{
	icon_state = "arrivals42"
	},
/area/shuttle/arrival)
"eb" = (
/turf/closed/wall/mineral/titanium/custom/arrivals{
	icon_state = "arrivals45"
	},
/area/shuttle/arrival)
"fF" = (
/obj/structure/chair/comfy/shuttle{
	dir = 1
	},
/obj/effect/turf_decal/loading_area{
	icon_state = "drain";
	name = "drain"
	},
/turf/open/floor/plasteel/dark{
	dir = 1;
	icon_state = "darkfull_plate"
	},
/area/shuttle/arrival)
"fS" = (
/turf/closed/wall/mineral/titanium/custom/window/arrivals{
	icon_state = "arrivals1"
	},
/area/shuttle/arrival)
"gu" = (
/turf/closed/wall/mineral/titanium/custom/arrivals{
	icon_state = "arrivals15"
	},
/area/shuttle/arrival)
"gC" = (
/turf/closed/wall/mineral/titanium/custom/window/arrivals{
	icon_state = "arrivals35"
	},
/area/shuttle/arrival)
"gK" = (
/obj/structure/window/reinforced/fulltile,
/obj/structure/flora/ausbushes/ywflowers,
/obj/structure/flora/ausbushes/brflowers,
/obj/structure/flora/ausbushes/grassybush,
/obj/machinery/light{
	pixel_y = -1
	},
/turf/open/floor/grass,
/area/shuttle/arrival)
"gN" = (
/turf/closed/wall/mineral/titanium/custom/arrivals{
	icon_state = "arrivals20"
	},
/area/shuttle/arrival)
"jg" = (
/turf/closed/wall/mineral/titanium/custom/arrivals{
	icon_state = "arrivals52"
	},
/area/shuttle/arrival)
"kq" = (
/turf/closed/wall/mineral/titanium/custom/window/arrivals{
	icon_state = "arrivals10"
	},
/area/shuttle/arrival)
"ks" = (
/turf/closed/wall/mineral/titanium/custom/window/arrivals{
	icon_state = "arrivals25"
	},
/area/shuttle/arrival)
"kF" = (
/obj/effect/turf_decal/tile/neutral{
	dir = 9
	},
/obj/effect/turf_decal/loading_area{
	dir = 1;
	icon_state = "drain";
	name = "drain"
	},
/obj/item/radio/intercom{
	pixel_x = -30
	},
/turf/open/floor/plasteel/dark{
	dir = 1;
	icon_state = "darkfull_trim"
	},
/area/shuttle/arrival)
"lo" = (
/turf/closed/wall/mineral/titanium/custom/window/arrivals{
	icon_state = "arrivals46"
	},
/area/shuttle/arrival)
"lt" = (
/turf/closed/wall/mineral/titanium/custom/window/arrivals{
	icon_state = "arrivals49"
	},
/area/shuttle/arrival)
"lE" = (
/turf/closed/wall/mineral/titanium/custom/arrivals{
	icon_state = "arrivals44"
	},
/area/shuttle/arrival)
"mi" = (
/turf/closed/wall/mineral/titanium/custom/window/arrivals{
	icon_state = "arrivals2"
	},
/area/shuttle/arrival)
"mA" = (
/obj/effect/turf_decal/loading_area{
	color = "#55391A";
	icon_state = "siding_wood_line";
	name = "wood"
	},
/obj/effect/turf_decal/loading_area{
	color = "#55391A";
	dir = 1;
	icon_state = "siding_wood_line";
	name = "wood"
	},
/turf/open/floor/wood{
	icon_state = "wood_tile";
	name = "tile"
	},
/area/shuttle/arrival)
"nC" = (
/turf/closed/wall/mineral/titanium/custom/window/arrivals{
	icon_state = "arrivals41"
	},
/area/shuttle/arrival)
"nO" = (
/turf/closed/wall/mineral/titanium/custom/arrivals{
	icon_state = "arrivals4"
	},
/area/shuttle/arrival)
"ov" = (
/turf/closed/wall/mineral/titanium/custom/window/arrivals{
	icon_state = "arrivals48"
	},
/area/shuttle/arrival)
"oD" = (
/obj/structure/fans/tiny,
/obj/effect/turf_decal/stripes/line{
	dir = 1
	},
/obj/machinery/door/airlock/titanium{
	name = "Arrivals Shuttle Airlock"
	},
/turf/open/floor/plasteel/dark{
	icon_state = "darkfull_whole_alt"
	},
/area/shuttle/arrival)
"ph" = (
/turf/closed/wall/mineral/titanium/custom/arrivals{
	icon_state = "arrivals3"
	},
/area/shuttle/arrival)
"pB" = (
/turf/closed/wall/mineral/titanium/custom/arrivals{
	icon_state = "arrivals37"
	},
/area/shuttle/arrival)
"pZ" = (
/turf/closed/wall/mineral/titanium/custom/window/arrivals{
	icon_state = "arrivals9"
	},
/area/shuttle/arrival)
"qa" = (
/turf/closed/wall/mineral/titanium/custom/window/arrivals{
	icon_state = "arrivals26"
	},
/area/shuttle/arrival)
"qw" = (
/obj/effect/turf_decal/tile/neutral{
	dir = 9
	},
/obj/effect/turf_decal/loading_area{
	dir = 1;
	icon_state = "drain";
	name = "drain"
	},
/turf/open/floor/plasteel/dark{
	dir = 1;
	icon_state = "darkfull_trim"
	},
/area/shuttle/arrival)
"qz" = (
/turf/closed/wall/mineral/titanium/custom/window/arrivals{
	icon_state = "arrivals53"
	},
/area/shuttle/arrival)
"qS" = (
/turf/closed/wall/mineral/titanium/custom/arrivals{
	icon_state = "arrivals21"
	},
/area/shuttle/arrival)
"rC" = (
/obj/structure/window/reinforced/fulltile,
/obj/structure/flora/ausbushes/ywflowers,
/obj/structure/flora/ausbushes/ppflowers,
/obj/structure/flora/ausbushes/sparsegrass,
/turf/open/floor/grass,
/area/shuttle/arrival)
"sd" = (
/obj/effect/turf_decal/tile/neutral{
	dir = 6
	},
/obj/effect/turf_decal/loading_area{
	icon_state = "drain";
	name = "drain"
	},
/obj/item/radio/intercom{
	pixel_x = -30
	},
/turf/open/floor/plasteel/dark{
	icon_state = "darkfull_trim"
	},
/area/shuttle/arrival)
"sk" = (
/turf/closed/wall/mineral/titanium/custom/arrivals{
	icon_state = "arrivals39"
	},
/area/shuttle/arrival)
"uf" = (
/obj/machinery/light{
	dir = 1
	},
/obj/structure/chair/comfy/shuttle,
/obj/effect/turf_decal/loading_area{
	dir = 1;
	icon_state = "drain";
	name = "drain"
	},
/turf/open/floor/plasteel/dark{
	icon_state = "darkfull_plate"
	},
/area/shuttle/arrival)
"uC" = (
/turf/closed/wall/mineral/titanium/custom/window/arrivals{
	icon_state = "arrivals13"
	},
/area/shuttle/arrival)
"vk" = (
/obj/effect/turf_decal/tile/neutral{
	dir = 6
	},
/obj/effect/turf_decal/tile/neutral{
	dir = 9
	},
/turf/open/floor/plasteel/dark{
	icon_state = "darkfull_whole_alt"
	},
/area/shuttle/arrival)
"xW" = (
/turf/closed/wall/mineral/titanium/custom/window/arrivals{
	icon_state = "arrivals27"
	},
/area/shuttle/arrival)
"yl" = (
/turf/closed/wall/mineral/titanium/custom/arrivals{
	icon_state = "arrivals51"
	},
/area/shuttle/arrival)
"yU" = (
/turf/closed/wall/mineral/titanium/custom/arrivals{
	icon_state = "arrivals28"
	},
/area/shuttle/arrival)
"ze" = (
/turf/closed/wall/mineral/titanium/custom/arrivals{
	icon_state = "arrivals31"
	},
/area/shuttle/arrival)
"zV" = (
/turf/closed/wall/mineral/titanium/custom/window/arrivals{
	icon_state = "arrivals40"
	},
/area/shuttle/arrival)
"Al" = (
/turf/closed/wall/mineral/titanium/custom/window/arrivals{
	icon_state = "arrivals32"
	},
/area/shuttle/arrival)
"CA" = (
/turf/closed/wall/mineral/titanium/custom/arrivals{
	icon_state = "arrivals12"
	},
/area/shuttle/arrival)
"Dm" = (
/obj/machinery/light{
	pixel_y = -1
	},
/obj/effect/turf_decal/tile/neutral{
	dir = 9
	},
/obj/structure/closet/emcloset{
	anchored = 1
	},
/turf/open/floor/plasteel/dark{
	dir = 1;
	icon_state = "darkfull_plate"
	},
/area/shuttle/arrival)
"EA" = (
/turf/closed/wall/mineral/titanium/custom/arrivals{
	icon_state = "arrivals6"
	},
/area/shuttle/arrival)
"HU" = (
/obj/structure/fans/tiny,
/obj/effect/turf_decal/stripes/line,
/obj/machinery/door/airlock/titanium{
	name = "Arrivals Shuttle Airlock"
	},
/turf/open/floor/plasteel/dark{
	icon_state = "darkfull_whole_alt"
	},
/area/shuttle/arrival)
"Il" = (
/turf/closed/wall/mineral/titanium/custom/arrivals{
	icon_state = "arrivals18"
	},
/area/shuttle/arrival)
"JU" = (
/obj/structure/chair/comfy/shuttle{
	dir = 8
	},
/obj/effect/turf_decal/tile/neutral{
	dir = 6
	},
/turf/open/floor/plasteel/dark{
	icon_state = "darkfull_plate"
	},
/area/shuttle/arrival)
"Kb" = (
/turf/closed/wall/mineral/titanium/custom/arrivals{
	icon_state = "arrivals47"
	},
/area/shuttle/arrival)
"KB" = (
/turf/template_noop,
/area/template_noop)
"KN" = (
/turf/closed/wall/mineral/titanium/custom/window/arrivals{
	icon_state = "arrivals16"
	},
/area/shuttle/arrival)
"Lv" = (
/turf/closed/wall/mineral/titanium/custom/window/arrivals{
	icon_state = "arrivals19"
	},
/area/shuttle/arrival)
"My" = (
/obj/machinery/door/airlock/titanium{
	name = "Arrivals Shuttle Airlock"
	},
/obj/effect/turf_decal/delivery/white,
/turf/open/floor/plasteel/dark{
	icon_state = "darkfull_whole_alt"
	},
/area/shuttle/arrival)
"Ov" = (
/turf/closed/wall/mineral/titanium/custom/arrivals{
	icon_state = "arrivals7"
	},
/area/shuttle/arrival)
"OQ" = (
/obj/structure/window/reinforced/fulltile,
/obj/structure/flora/ausbushes/ywflowers,
/obj/structure/flora/ausbushes/brflowers,
/obj/structure/flora/ausbushes/leafybush,
/obj/machinery/light{
	dir = 1
	},
/turf/open/floor/grass,
/area/shuttle/arrival)
"OT" = (
/turf/closed/wall/mineral/titanium/custom/arrivals{
	icon_state = "arrivals50"
	},
/area/shuttle/arrival)
"Pb" = (
/obj/machinery/light{
	dir = 1
	},
/obj/effect/turf_decal/tile/neutral{
	dir = 6
	},
/obj/structure/table,
/obj/item/storage/firstaid/regular,
/turf/open/floor/plasteel/dark{
	icon_state = "darkfull_plate"
	},
/area/shuttle/arrival)
"Pr" = (
/turf/closed/wall/mineral/titanium/custom/arrivals{
	icon_state = "arrivals24"
	},
/area/shuttle/arrival)
"PR" = (
/turf/closed/wall/mineral/titanium/custom/window/arrivals{
	icon_state = "arrivals23"
	},
/area/shuttle/arrival)
"Qd" = (
/turf/closed/wall/mineral/titanium/custom/window/arrivals{
	icon_state = "arrivals34"
	},
/area/shuttle/arrival)
"QB" = (
/obj/effect/turf_decal/loading_area{
	color = "#55391A";
	dir = 8;
	icon_state = "siding_wood_line";
	name = "wood"
	},
/obj/effect/turf_decal/loading_area{
	color = "#55391A";
	icon_state = "siding_wood_line";
	name = "wood"
	},
/obj/effect/turf_decal/loading_area{
	color = "#55391A";
	dir = 1;
	icon_state = "siding_wood_line";
	name = "wood"
	},
/turf/open/floor/wood{
	icon_state = "wood_tile";
	name = "tile"
	},
/area/shuttle/arrival)
"QK" = (
/obj/effect/turf_decal/tile/neutral{
	dir = 6
	},
/obj/effect/turf_decal/loading_area{
	icon_state = "drain";
	name = "drain"
	},
/turf/open/floor/plasteel/dark{
	icon_state = "darkfull_trim"
	},
/area/shuttle/arrival)
"Sb" = (
/turf/closed/wall/mineral/titanium/custom/arrivals{
	icon_state = "arrivals0"
	},
/area/shuttle/arrival)
"Sp" = (
/obj/machinery/light{
	pixel_y = -1
	},
/obj/structure/chair/comfy/shuttle{
	dir = 1
	},
/obj/effect/turf_decal/loading_area{
	icon_state = "drain";
	name = "drain"
	},
/turf/open/floor/plasteel/dark{
	dir = 1;
	icon_state = "darkfull_plate"
	},
/area/shuttle/arrival)
"TW" = (
/turf/closed/wall/mineral/titanium/custom/window/arrivals{
	icon_state = "arrivals11"
	},
/area/shuttle/arrival)
"UU" = (
/obj/effect/turf_decal/loading_area{
	color = "#55391A";
	dir = 4;
	icon_state = "siding_wood_line";
	name = "wood"
	},
/obj/effect/turf_decal/loading_area{
	color = "#55391A";
	icon_state = "siding_wood_line";
	name = "wood"
	},
/obj/effect/turf_decal/loading_area{
	color = "#55391A";
	dir = 1;
	icon_state = "siding_wood_line";
	name = "wood"
	},
/turf/open/floor/wood{
	icon_state = "wood_tile";
	name = "tile"
	},
/area/shuttle/arrival)
"VR" = (
/turf/closed/wall/mineral/titanium/custom/arrivals{
	icon_state = "arrivals17"
	},
/area/shuttle/arrival)
"We" = (
/obj/docking_port/mobile/arrivals,
/turf/closed/wall/mineral/titanium/custom/window/arrivals{
	icon_state = "arrivals30"
	},
/area/shuttle/arrival)
"Wi" = (
/turf/closed/wall/mineral/titanium/custom/window/arrivals{
	icon_state = "arrivals14"
	},
/area/shuttle/arrival)
"WM" = (
/turf/closed/wall/mineral/titanium/custom/window/arrivals{
	icon_state = "arrivals8"
	},
/area/shuttle/arrival)
"WO" = (
/obj/structure/chair/comfy/shuttle{
	dir = 8
	},
/obj/effect/turf_decal/tile/neutral{
	dir = 6
	},
/obj/effect/turf_decal/loading_area{
	icon_state = "drain";
	name = "drain"
	},
/turf/open/floor/plasteel/dark{
	icon_state = "darkfull_plate"
	},
/area/shuttle/arrival)
"YZ" = (
/obj/structure/chair/comfy/shuttle,
/obj/effect/turf_decal/loading_area{
	dir = 1;
	icon_state = "drain";
	name = "drain"
	},
/turf/open/floor/plasteel/dark{
	icon_state = "darkfull_plate"
	},
/area/shuttle/arrival)
"Zg" = (
/turf/closed/wall/mineral/titanium/custom/arrivals{
	icon_state = "arrivals36"
	},
/area/shuttle/arrival)
"Zm" = (
/obj/effect/turf_decal/tile/neutral{
	dir = 9
	},
/turf/open/floor/plasteel/dark{
	dir = 1;
	icon_state = "darkfull_plate"
	},
/area/shuttle/arrival)
"Zu" = (
/obj/structure/chair/comfy/shuttle{
	dir = 8
	},
/obj/effect/turf_decal/tile/neutral{
	dir = 9
	},
/obj/effect/turf_decal/loading_area{
	dir = 1;
	icon_state = "drain";
	name = "drain"
	},
/turf/open/floor/plasteel/dark{
	dir = 1;
	icon_state = "darkfull_plate"
	},
/area/shuttle/arrival)
"Zw" = (
/obj/structure/chair/comfy/shuttle{
	dir = 8
	},
/obj/effect/turf_decal/tile/neutral{
	dir = 9
	},
/turf/open/floor/plasteel/dark{
	dir = 1;
	icon_state = "darkfull_plate"
	},
/area/shuttle/arrival)
"ZT" = (
/turf/closed/wall/mineral/titanium/custom/window/arrivals{
	icon_state = "arrivals43"
	},
/area/shuttle/arrival)
"ZZ" = (
/obj/effect/turf_decal/tile/neutral{
	dir = 6
	},
/turf/open/floor/plasteel/dark{
	icon_state = "darkfull_plate"
	},
/area/shuttle/arrival)

(1,1,1) = {"
KB
TW
cn
ks
cO
Al
KB
"}
(2,1,1) = {"
KB
Wi
YZ
vk
fF
gC
KB
"}
(3,1,1) = {"
mi
uC
uf
vk
Sp
cw
ZT
"}
(4,1,1) = {"
fS
CA
qS
My
yU
pB
lo
"}
(5,1,1) = {"
Sb
gu
Pb
QB
Dm
Zg
eb
"}
(6,1,1) = {"
oD
kF
ZZ
mA
Zm
sd
HU
"}
(7,1,1) = {"
ph
Zu
JU
mA
Zw
WO
lE
"}
(8,1,1) = {"
EA
Zu
JU
mA
Zw
WO
jg
"}
(9,1,1) = {"
EA
Zu
JU
mA
Zw
WO
Kb
"}
(10,1,1) = {"
nO
Zu
JU
mA
Zw
WO
yl
"}
(11,1,1) = {"
oD
qw
ZZ
UU
Zm
QK
HU
"}
(12,1,1) = {"
Ov
Il
OQ
rC
gK
sk
OT
"}
(13,1,1) = {"
kq
VR
gN
Pr
ze
dO
lt
"}
(14,1,1) = {"
pZ
KN
PR
xW
Qd
nC
ov
"}
(15,1,1) = {"
WM
Lv
qa
We
de
zV
qz
"}
