"aa" = (/obj/machinery/porta_turret/centcom_shuttle{dir = 9},/turf/closed/wall/mineral/plastitanium/interior,/area/shuttle/escape)
"ab" = (/obj/machinery/status_display/evac,/turf/closed/wall/mineral/plastitanium/interior,/area/shuttle/escape)
"ac" = (/obj/machinery/door/poddoor/shutters{id = "shuttleshutters"; name = "blast shutters"},/obj/structure/grille,/obj/structure/window/plastitanium,/turf/open/floor/plating,/area/shuttle/escape)
"ad" = (/turf/template_noop,/area/template_noop)
"ae" = (/obj/structure/table/reinforced,/obj/machinery/recharger,/obj/effect/turf_decal/tile/neutral{dir = 1},/obj/effect/turf_decal/tile/neutral,/obj/effect/turf_decal/tile/neutral{dir = 4},/obj/effect/turf_decal/tile/neutral{dir = 8},/turf/open/floor/plasteel/dark,/area/shuttle/escape)
"af" = (/obj/structure/table/reinforced,/obj/item/storage/fancy/donut_box,/obj/effect/turf_decal/tile/neutral{dir = 1},/obj/effect/turf_decal/tile/neutral,/obj/effect/turf_decal/tile/neutral{dir = 4},/obj/effect/turf_decal/tile/neutral{dir = 8},/turf/open/floor/plasteel/dark,/area/shuttle/escape)
"ag" = (/obj/machinery/computer/med_data,/turf/open/floor/plasteel/dark,/area/shuttle/escape)
"ah" = (/obj/machinery/computer/shuttle,/turf/open/floor/plasteel/dark,/area/shuttle/escape)
"ai" = (/obj/machinery/computer/communications,/turf/open/floor/plasteel/dark,/area/shuttle/escape)
"aj" = (/obj/machinery/computer/crew,/turf/open/floor/plasteel/dark,/area/shuttle/escape)
"ak" = (/obj/structure/table/reinforced,/obj/item/restraints/handcuffs,/obj/item/assembly/flash,/obj/effect/turf_decal/tile/neutral{dir = 1},/obj/effect/turf_decal/tile/neutral,/obj/effect/turf_decal/tile/neutral{dir = 4},/obj/effect/turf_decal/tile/neutral{dir = 8},/turf/open/floor/plasteel/dark,/area/shuttle/escape)
"al" = (/obj/structure/table/reinforced,/obj/item/storage/firstaid/regular,/obj/effect/turf_decal/tile/neutral{dir = 1},/obj/effect/turf_decal/tile/neutral,/obj/effect/turf_decal/tile/neutral{dir = 4},/obj/effect/turf_decal/tile/neutral{dir = 8},/turf/open/floor/plasteel/dark,/area/shuttle/escape)
"am" = (/obj/machinery/computer/security{dir = 4},/turf/open/floor/plasteel/dark,/area/shuttle/escape)
"an" = (/obj/effect/turf_decal/tile/blue{dir = 1},/obj/effect/turf_decal/tile/blue{dir = 4},/obj/effect/turf_decal/tile/blue{dir = 8},/turf/open/floor/plasteel/dark,/area/shuttle/escape)
"ao" = (/obj/structure/chair/office/dark{dir = 1},/obj/effect/turf_decal/tile/blue{dir = 1},/obj/effect/turf_decal/tile/blue{dir = 4},/turf/open/floor/plasteel/dark,/area/shuttle/escape)
"ap" = (/obj/effect/turf_decal/tile/blue{dir = 1},/obj/effect/turf_decal/tile/blue,/obj/effect/turf_decal/tile/blue{dir = 4},/turf/open/floor/plasteel/dark,/area/shuttle/escape)
"aq" = (/obj/machinery/computer/station_alert{dir = 8},/turf/open/floor/plasteel/dark,/area/shuttle/escape)
"ar" = (/turf/closed/wall/mineral/plastitanium,/area/shuttle/escape)
"as" = (/obj/structure/table/optable,/obj/item/surgical_drapes,/obj/item/clothing/gloves/color/latex,/obj/item/clothing/mask/surgical,/obj/effect/turf_decal/tile/purple{dir = 1},/obj/effect/turf_decal/tile/purple{dir = 4},/turf/open/floor/plasteel/dark,/area/shuttle/escape)
"at" = (/obj/machinery/computer/operating,/obj/effect/turf_decal/tile/purple{dir = 1},/obj/effect/turf_decal/tile/purple{dir = 4},/turf/open/floor/plasteel/dark,/area/shuttle/escape)
"au" = (/obj/machinery/computer/secure_data{dir = 4},/turf/open/floor/plasteel/dark,/area/shuttle/escape)
"av" = (/obj/structure/chair/office/dark{dir = 8},/obj/effect/turf_decal/tile/blue{dir = 1},/obj/effect/turf_decal/tile/blue,/obj/effect/turf_decal/tile/blue{dir = 8},/turf/open/floor/plasteel/dark,/area/shuttle/escape)
"aw" = (/obj/machinery/light,/obj/effect/turf_decal/tile/blue,/obj/effect/turf_decal/tile/blue{dir = 8},/turf/open/floor/plasteel/dark,/area/shuttle/escape)
"ax" = (/obj/effect/turf_decal/tile/blue{dir = 8},/turf/open/floor/plasteel/dark,/area/shuttle/escape)
"ay" = (/obj/effect/turf_decal/tile/blue,/turf/open/floor/plasteel/dark,/area/shuttle/escape)
"az" = (/obj/structure/chair/office/dark{dir = 4},/obj/effect/turf_decal/tile/blue,/obj/effect/turf_decal/tile/blue{dir = 4},/obj/effect/turf_decal/tile/blue{dir = 8},/turf/open/floor/plasteel/dark,/area/shuttle/escape)
"aA" = (/obj/machinery/computer/atmos_alert{dir = 8},/turf/open/floor/plasteel/dark,/area/shuttle/escape)
"aB" = (/obj/structure/table/reinforced,/obj/item/scalpel,/obj/item/circular_saw,/obj/item/retractor,/obj/item/hemostat,/obj/effect/turf_decal/tile/purple{dir = 1},/obj/effect/turf_decal/tile/purple{dir = 8},/obj/item/surgicaldrill,/obj/item/cautery,/turf/open/floor/plasteel/dark,/area/shuttle/escape)
"aC" = (/turf/open/floor/plasteel/dark,/area/shuttle/escape)
"aD" = (/obj/structure/chair/office/dark{dir = 1},/turf/open/floor/plasteel/dark,/area/shuttle/escape)
"aE" = (/obj/structure/table/reinforced,/obj/item/defibrillator/loaded,/obj/machinery/light{dir = 4},/obj/effect/turf_decal/tile/purple,/obj/effect/turf_decal/tile/purple{dir = 4},/turf/open/floor/plasteel/dark,/area/shuttle/escape)
"aF" = (/obj/machinery/door/airlock/hatch{name = "Shuttle Bridge Access"; req_access_txt = "19"},/obj/effect/turf_decal/tile/blue{dir = 1},/obj/effect/turf_decal/tile/blue{dir = 8},/turf/open/floor/plasteel/dark,/area/shuttle/escape)
"aG" = (/obj/machinery/door/airlock/hatch{name = "Shuttle Bridge Access"; req_access_txt = "19"},/obj/effect/turf_decal/tile/blue,/obj/effect/turf_decal/tile/blue{dir = 4},/turf/open/floor/plasteel/dark,/area/shuttle/escape)
"aH" = (/obj/machinery/shower{dir = 4; name = "emergency shower"},/obj/effect/turf_decal/tile/purple{dir = 1},/obj/effect/turf_decal/tile/purple{dir = 8},/turf/open/floor/plasteel/dark,/area/shuttle/escape)
"aI" = (/obj/structure/sink{dir = 4; pixel_x = 11},/obj/effect/turf_decal/tile/purple,/obj/effect/turf_decal/tile/purple{dir = 4},/turf/open/floor/plasteel/dark,/area/shuttle/escape)
"aJ" = (/obj/machinery/button/flasher{id = "shuttleflash"; pixel_y = -23},/obj/machinery/light{dir = 1},/obj/effect/turf_decal/tile/blue{dir = 1},/obj/effect/turf_decal/tile/blue{dir = 4},/turf/open/floor/plasteel/dark,/area/shuttle/escape)
"aK" = (/obj/effect/turf_decal/tile/blue{dir = 1},/turf/open/floor/plasteel/dark,/area/shuttle/escape)
"aL" = (/obj/effect/turf_decal/tile/blue{dir = 4},/turf/open/floor/plasteel/dark,/area/shuttle/escape)
"aM" = (/obj/machinery/light{dir = 1},/obj/effect/turf_decal/tile/blue{dir = 1},/obj/effect/turf_decal/tile/blue{dir = 4},/turf/open/floor/plasteel/dark,/area/shuttle/escape)
"aN" = (/obj/machinery/door/airlock/hatch,/obj/effect/turf_decal/tile/purple{dir = 1},/obj/effect/turf_decal/tile/purple{dir = 8},/turf/open/floor/plasteel/dark,/area/shuttle/escape)
"aO" = (/obj/machinery/door/airlock/hatch,/obj/effect/turf_decal/tile/purple,/obj/effect/turf_decal/tile/purple{dir = 4},/turf/open/floor/plasteel/dark,/area/shuttle/escape)
"aP" = (/obj/machinery/door/airlock/hatch{name = "Shuttle Security Bride Access"; req_access_txt = "2"},/turf/open/floor/plasteel/dark,/area/shuttle/escape)
"aQ" = (/obj/machinery/door/airlock/hatch{name = "Shuttle Bridge Access"; req_access_txt = "19"},/turf/open/floor/plasteel/dark,/area/shuttle/escape)
"aR" = (/obj/machinery/door/airlock/hatch{name = "Shuttle EVA"; req_access_txt = "19"},/turf/open/floor/plasteel/dark,/area/shuttle/escape)
"aS" = (/obj/effect/turf_decal/tile/purple{dir = 1},/obj/effect/turf_decal/tile/purple{dir = 8},/turf/open/floor/plasteel/dark,/area/shuttle/escape)
"aT" = (/obj/structure/table/reinforced,/obj/item/storage/firstaid/o2{pixel_x = 4; pixel_y = 4},/obj/item/storage/firstaid/toxin,/turf/open/floor/plasteel/dark,/area/shuttle/escape)
"aU" = (/obj/structure/table/reinforced,/obj/item/storage/firstaid/brute{pixel_x = 3; pixel_y = 4},/obj/item/storage/firstaid/fire,/turf/open/floor/plasteel/dark,/area/shuttle/escape)
"aV" = (/obj/effect/turf_decal/tile/purple,/obj/effect/turf_decal/tile/purple{dir = 4},/turf/open/floor/plasteel/dark,/area/shuttle/escape)
"aW" = (/turf/open/floor/mineral/plastitanium/red,/area/shuttle/escape)
"aX" = (/obj/machinery/door/airlock/hatch,/obj/structure/fans/tiny,/turf/open/floor/plating,/area/shuttle/escape)
"aY" = (/obj/docking_port/mobile/emergency{dwidth = 14; height = 18; name = "CentCom Raven Battlecruiser"; width = 32},/obj/machinery/door/airlock/hatch,/obj/structure/fans/tiny,/turf/open/floor/plating,/area/shuttle/escape)
"aZ" = (/obj/effect/turf_decal/tile/green,/obj/effect/turf_decal/tile/green{dir = 4},/turf/open/floor/plasteel/dark,/area/shuttle/escape)
"ba" = (/obj/effect/turf_decal/tile/yellow{dir = 1},/obj/effect/turf_decal/tile/yellow{dir = 8},/turf/open/floor/plasteel/dark,/area/shuttle/escape)
"bb" = (/obj/item/clothing/suit/hazardvest{desc = "A high-visibility lifejacket complete with whistle and slot for oxygen tanks."; name = "emergency lifejacket"},/obj/item/clothing/suit/hazardvest{desc = "A high-visibility lifejacket complete with whistle and slot for oxygen tanks."; name = "emergency lifejacket"},/obj/item/clothing/suit/hazardvest{desc = "A high-visibility lifejacket complete with whistle and slot for oxygen tanks."; name = "emergency lifejacket"},/obj/item/clothing/suit/hazardvest{desc = "A high-visibility lifejacket complete with whistle and slot for oxygen tanks."; name = "emergency lifejacket"},/obj/item/clothing/suit/hazardvest{desc = "A high-visibility lifejacket complete with whistle and slot for oxygen tanks."; name = "emergency lifejacket"},/obj/item/tank/internals/emergency_oxygen/double{pixel_x = 3},/obj/item/tank/internals/emergency_oxygen/double{pixel_x = 3},/obj/item/tank/internals/emergency_oxygen/double{pixel_x = 3},/obj/item/tank/internals/emergency_oxygen/double{pixel_x = 3},/obj/item/tank/internals/emergency_oxygen/double{pixel_x = 3},/obj/item/clothing/mask/breath{pixel_x = -3; pixel_y = -3},/obj/item/clothing/mask/breath{pixel_x = -3; pixel_y = -3},/obj/item/clothing/mask/breath{pixel_x = -3; pixel_y = -3},/obj/item/clothing/mask/breath{pixel_x = -3; pixel_y = -3},/obj/item/clothing/mask/breath{pixel_x = -3; pixel_y = -3},/obj/item/clothing/head/hardhat/orange{name = "protective hat"; pixel_y = 9},/obj/item/clothing/head/hardhat/orange{name = "protective hat"; pixel_y = 9},/obj/item/clothing/head/hardhat/orange{name = "protective hat"; pixel_y = 9},/obj/item/clothing/head/hardhat/orange{name = "protective hat"; pixel_y = 9},/obj/item/clothing/head/hardhat/orange{name = "protective hat"; pixel_y = 9},/obj/structure/closet/crate/internals,/obj/machinery/light{dir = 1},/obj/effect/turf_decal/tile/yellow{dir = 1},/obj/effect/turf_decal/tile/yellow,/obj/effect/turf_decal/tile/yellow{dir = 4},/turf/open/floor/plasteel/dark,/area/shuttle/escape)
"bd" = (/obj/structure/chair/comfy/shuttle{dir = 8},/turf/open/floor/mineral/plastitanium/red,/area/shuttle/escape)
"be" = (/obj/effect/turf_decal/tile/green{dir = 1},/obj/effect/turf_decal/tile/green{dir = 8},/turf/open/floor/plasteel/dark,/area/shuttle/escape)
"bf" = (/obj/effect/turf_decal/tile/yellow,/obj/effect/turf_decal/tile/yellow{dir = 4},/turf/open/floor/plasteel/dark,/area/shuttle/escape)
"bg" = (/obj/structure/table/reinforced,/obj/item/storage/firstaid,/obj/effect/turf_decal/tile/purple{dir = 1},/obj/effect/turf_decal/tile/purple{dir = 8},/turf/open/floor/plasteel/dark,/area/shuttle/escape)
"bh" = (/obj/structure/chair/office/dark{dir = 8},/turf/open/floor/plasteel/dark,/area/shuttle/escape)
"bi" = (/obj/structure/bed/roller,/obj/machinery/iv_drip,/obj/effect/turf_decal/tile/purple,/obj/effect/turf_decal/tile/purple{dir = 4},/turf/open/floor/plasteel/dark,/area/shuttle/escape)
"bj" = (/obj/machinery/suit_storage_unit/standard_unit,/obj/effect/turf_decal/tile/yellow{dir = 1},/obj/effect/turf_decal/tile/yellow,/obj/effect/turf_decal/tile/yellow{dir = 8},/turf/open/floor/plasteel/dark,/area/shuttle/escape)
"bk" = (/obj/machinery/suit_storage_unit/standard_unit,/obj/effect/turf_decal/tile/yellow,/obj/effect/turf_decal/tile/yellow{dir = 4},/obj/effect/turf_decal/tile/yellow{dir = 8},/turf/open/floor/plasteel/dark,/area/shuttle/escape)
"bl" = (/obj/item/reagent_containers/glass/bottle/epinephrine{pixel_x = 6},/obj/item/reagent_containers/glass/bottle/charcoal{pixel_x = -3},/obj/item/reagent_containers/glass/bottle/epinephrine{pixel_x = -3; pixel_y = 8},/obj/item/reagent_containers/glass/bottle/charcoal{pixel_x = 6; pixel_y = 8},/obj/item/reagent_containers/syringe/epinephrine{pixel_x = 3; pixel_y = -2},/obj/item/reagent_containers/syringe/epinephrine{pixel_x = 4; pixel_y = 1},/obj/item/reagent_containers/syringe/epinephrine{pixel_x = -2; pixel_y = 5},/obj/item/reagent_containers/syringe/epinephrine{pixel_x = 2; pixel_y = 8},/obj/structure/table/reinforced,/obj/machinery/light{dir = 8},/obj/effect/turf_decal/tile/purple{dir = 1},/obj/effect/turf_decal/tile/purple{dir = 8},/turf/open/floor/plasteel/dark,/area/shuttle/escape)
"bm" = (/obj/machinery/sleeper{dir = 8},/obj/effect/turf_decal/tile/purple,/obj/effect/turf_decal/tile/purple{dir = 4},/turf/open/floor/plasteel/dark,/area/shuttle/escape)
"bn" = (/obj/structure/table/reinforced,/obj/machinery/recharger,/turf/open/floor/mineral/plastitanium/red,/area/shuttle/escape)
"bo" = (/obj/machinery/status_display/evac,/turf/closed/wall/mineral/plastitanium,/area/shuttle/escape)
"bp" = (/obj/effect/turf_decal/tile/purple{dir = 1},/obj/effect/turf_decal/tile/purple{dir = 8},/mob/living/simple_animal/bot/medbot{name = "\improper emergency medibot"; pixel_x = -3; pixel_y = 2},/turf/open/floor/plasteel/dark,/area/shuttle/escape)
"bq" = (/obj/effect/turf_decal/tile/green{dir = 4},/turf/open/floor/plasteel/dark,/area/shuttle/escape)
"br" = (/obj/effect/turf_decal/tile/green{dir = 1},/obj/effect/turf_decal/tile/green{dir = 4},/turf/open/floor/plasteel/dark,/area/shuttle/escape)
"bs" = (/obj/machinery/door/airlock/hatch,/turf/open/floor/plasteel/dark,/area/shuttle/escape)
"bt" = (/obj/effect/turf_decal/tile/purple{dir = 1},/obj/effect/turf_decal/tile/purple{dir = 4},/turf/open/floor/plasteel/dark,/area/shuttle/escape)
"bu" = (/obj/effect/turf_decal/tile/purple{dir = 1},/turf/open/floor/plasteel/dark,/area/shuttle/escape)
"bv" = (/obj/structure/chair/office/dark,/turf/open/floor/plasteel/dark,/area/shuttle/escape)
"by" = (/obj/effect/turf_decal/tile/green,/turf/open/floor/plasteel/dark,/area/shuttle/escape)
"bz" = (/obj/effect/turf_decal/tile/green,/obj/effect/turf_decal/tile/green{dir = 8},/turf/open/floor/plasteel/dark,/area/shuttle/escape)
"bA" = (/obj/effect/turf_decal/tile/purple,/obj/effect/turf_decal/tile/purple{dir = 8},/turf/open/floor/plasteel/dark,/area/shuttle/escape)
"bB" = (/obj/structure/table/reinforced,/obj/item/paper_bin,/obj/item/pen/blue,/obj/effect/turf_decal/tile/purple,/obj/effect/turf_decal/tile/purple{dir = 8},/turf/open/floor/plasteel/dark,/area/shuttle/escape)
"bC" = (/obj/machinery/computer/med_data{dir = 1},/obj/effect/turf_decal/tile/purple,/obj/effect/turf_decal/tile/purple{dir = 8},/turf/open/floor/plasteel/dark,/area/shuttle/escape)
"bD" = (/obj/machinery/door/airlock/hatch{name = "Shuttle Brig"; req_access_txt = "2"},/turf/open/floor/plasteel/dark,/area/shuttle/escape)
"bF" = (/obj/effect/turf_decal/tile/green{dir = 1},/obj/effect/turf_decal/tile/green{dir = 4},/obj/effect/turf_decal/tile/green{dir = 8},/turf/open/floor/plasteel/dark,/area/shuttle/escape)
"bG" = (/obj/effect/turf_decal/tile/green{dir = 1},/turf/open/floor/plasteel/dark,/area/shuttle/escape)
"bH" = (/obj/structure/rack,/obj/item/storage/toolbox/electrical{pixel_x = -2; pixel_y = 5},/obj/item/storage/toolbox/emergency,/obj/item/storage/toolbox/mechanical{pixel_x = 3; pixel_y = -6},/obj/effect/turf_decal/tile/green{dir = 1},/obj/effect/turf_decal/tile/green{dir = 4},/obj/effect/turf_decal/tile/green{dir = 8},/turf/open/floor/plasteel/dark,/area/shuttle/escape)
"bI" = (/obj/structure/rack,/obj/item/clothing/suit/fire/firefighter,/obj/item/tank/internals/oxygen/red,/obj/item/clothing/mask/gas,/obj/item/clothing/head/hardhat/red,/obj/effect/turf_decal/tile/green{dir = 1},/obj/effect/turf_decal/tile/green,/obj/effect/turf_decal/tile/green{dir = 4},/turf/open/floor/plasteel/dark,/area/shuttle/escape)
"bJ" = (/obj/structure/grille,/obj/structure/window/plastitanium,/turf/open/floor/plating,/area/shuttle/escape)
"bK" = (/obj/structure/chair/comfy/shuttle,/obj/effect/turf_decal/tile/green{dir = 1},/obj/effect/turf_decal/tile/green{dir = 8},/turf/open/floor/plasteel/dark,/area/shuttle/escape)
"bL" = (/obj/machinery/door/airlock/hatch,/obj/effect/turf_decal/tile/green{dir = 1},/obj/effect/turf_decal/tile/green{dir = 4},/turf/open/floor/plasteel/dark,/area/shuttle/escape)
"bM" = (/obj/structure/table/reinforced,/obj/item/dice/d20,/obj/effect/turf_decal/tile/green{dir = 1},/obj/effect/turf_decal/tile/green,/obj/effect/turf_decal/tile/green{dir = 8},/turf/open/floor/plasteel/dark,/area/shuttle/escape)
"bN" = (/obj/structure/chair/comfy/shuttle{dir = 8},/obj/effect/turf_decal/tile/green,/obj/effect/turf_decal/tile/green{dir = 8},/turf/open/floor/plasteel/dark,/area/shuttle/escape)
"bO" = (/obj/effect/turf_decal/tile/green{dir = 8},/turf/open/floor/plasteel/dark,/area/shuttle/escape)
"bP" = (/obj/machinery/door/airlock/hatch,/obj/effect/turf_decal/tile/green,/obj/effect/turf_decal/tile/green{dir = 8},/turf/open/floor/plasteel/dark,/area/shuttle/escape)
"bQ" = (/obj/item/clothing/suit/hazardvest{desc = "A high-visibility lifejacket complete with whistle and slot for oxygen tanks."; name = "emergency lifejacket"},/obj/item/clothing/suit/hazardvest{desc = "A high-visibility lifejacket complete with whistle and slot for oxygen tanks."; name = "emergency lifejacket"},/obj/item/clothing/suit/hazardvest{desc = "A high-visibility lifejacket complete with whistle and slot for oxygen tanks."; name = "emergency lifejacket"},/obj/item/clothing/suit/hazardvest{desc = "A high-visibility lifejacket complete with whistle and slot for oxygen tanks."; name = "emergency lifejacket"},/obj/item/clothing/suit/hazardvest{desc = "A high-visibility lifejacket complete with whistle and slot for oxygen tanks."; name = "emergency lifejacket"},/obj/item/tank/internals/emergency_oxygen/double{pixel_x = 3},/obj/item/tank/internals/emergency_oxygen/double{pixel_x = 3},/obj/item/tank/internals/emergency_oxygen/double{pixel_x = 3},/obj/item/tank/internals/emergency_oxygen/double{pixel_x = 3},/obj/item/tank/internals/emergency_oxygen/double{pixel_x = 3},/obj/item/clothing/mask/breath{pixel_x = -3; pixel_y = -3},/obj/item/clothing/mask/breath{pixel_x = -3; pixel_y = -3},/obj/item/clothing/mask/breath{pixel_x = -3; pixel_y = -3},/obj/item/clothing/mask/breath{pixel_x = -3; pixel_y = -3},/obj/item/clothing/mask/breath{pixel_x = -3; pixel_y = -3},/obj/item/clothing/head/hardhat/orange{name = "protective hat"; pixel_y = 9},/obj/item/clothing/head/hardhat/orange{name = "protective hat"; pixel_y = 9},/obj/item/clothing/head/hardhat/orange{name = "protective hat"; pixel_y = 9},/obj/item/clothing/head/hardhat/orange{name = "protective hat"; pixel_y = 9},/obj/item/clothing/head/hardhat/orange{name = "protective hat"; pixel_y = 9},/obj/structure/closet/crate/internals,/obj/effect/turf_decal/tile/green,/obj/effect/turf_decal/tile/green{dir = 4},/obj/effect/turf_decal/tile/green{dir = 8},/turf/open/floor/plasteel/dark,/area/shuttle/escape)
"bR" = (/obj/machinery/door/airlock/hatch,/obj/effect/turf_decal/tile/green{dir = 1},/obj/effect/turf_decal/tile/green{dir = 8},/turf/open/floor/plasteel/dark,/area/shuttle/escape)
"bS" = (/obj/machinery/door/airlock/hatch,/obj/effect/turf_decal/tile/green,/obj/effect/turf_decal/tile/green{dir = 4},/turf/open/floor/plasteel/dark,/area/shuttle/escape)
"bT" = (/obj/machinery/recharge_station,/obj/effect/turf_decal/tile/green{dir = 1},/obj/effect/turf_decal/tile/green{dir = 4},/obj/effect/turf_decal/tile/green{dir = 8},/turf/open/floor/plasteel/dark,/area/shuttle/escape)
"bU" = (/obj/machinery/recharge_station,/obj/effect/turf_decal/tile/green{dir = 1},/obj/effect/turf_decal/tile/green,/obj/effect/turf_decal/tile/green{dir = 4},/turf/open/floor/plasteel/dark,/area/shuttle/escape)
"bV" = (/obj/item/twohanded/required/kirbyplants{icon_state = "plant-22"},/obj/effect/turf_decal/tile/green{dir = 1},/obj/effect/turf_decal/tile/green{dir = 4},/obj/effect/turf_decal/tile/green{dir = 8},/turf/open/floor/plasteel/dark,/area/shuttle/escape)
"bW" = (/obj/item/twohanded/required/kirbyplants{icon_state = "plant-22"},/obj/effect/turf_decal/tile/green{dir = 1},/obj/effect/turf_decal/tile/green,/obj/effect/turf_decal/tile/green{dir = 4},/turf/open/floor/plasteel/dark,/area/shuttle/escape)
"bX" = (/obj/structure/chair/comfy/shuttle{dir = 8},/obj/structure/window/reinforced{dir = 4},/turf/open/floor/plasteel/dark,/area/shuttle/escape)
"bY" = (/obj/structure/chair/comfy/shuttle{dir = 4},/obj/structure/window/reinforced{dir = 8},/turf/open/floor/plasteel/dark,/area/shuttle/escape)
"bZ" = (/obj/structure/chair/comfy/shuttle{dir = 1},/obj/structure/window/reinforced,/turf/open/floor/plasteel/dark,/area/shuttle/escape)
"ca" = (/obj/structure/chair/comfy/shuttle,/obj/structure/window/reinforced{dir = 1},/turf/open/floor/plasteel/dark,/area/shuttle/escape)
"cb" = (/obj/structure/chair/comfy/shuttle,/obj/effect/turf_decal/tile/green{dir = 1},/obj/effect/turf_decal/tile/green{dir = 4},/turf/open/floor/plasteel/dark,/area/shuttle/escape)
"cc" = (/obj/structure/chair/comfy/shuttle{dir = 1},/obj/effect/turf_decal/tile/green,/obj/effect/turf_decal/tile/green{dir = 8},/turf/open/floor/plasteel/dark,/area/shuttle/escape)
"cd" = (/obj/item/twohanded/required/kirbyplants{icon_state = "plant-22"},/obj/effect/turf_decal/tile/green{dir = 1},/obj/effect/turf_decal/tile/green,/obj/effect/turf_decal/tile/green{dir = 8},/turf/open/floor/plasteel/dark,/area/shuttle/escape)
"ce" = (/obj/item/twohanded/required/kirbyplants{icon_state = "plant-22"},/obj/effect/turf_decal/tile/green,/obj/effect/turf_decal/tile/green{dir = 4},/obj/effect/turf_decal/tile/green{dir = 8},/turf/open/floor/plasteel/dark,/area/shuttle/escape)
"ch" = (/obj/structure/reagent_dispensers/fueltank,/obj/machinery/light{dir = 8},/obj/effect/turf_decal/tile/green{dir = 1},/obj/effect/turf_decal/tile/green{dir = 4},/obj/effect/turf_decal/tile/green{dir = 8},/turf/open/floor/plasteel/dark,/area/shuttle/escape)
"ci" = (/obj/structure/reagent_dispensers/watertank,/obj/machinery/light{dir = 4},/obj/effect/turf_decal/tile/green{dir = 1},/obj/effect/turf_decal/tile/green,/obj/effect/turf_decal/tile/green{dir = 4},/turf/open/floor/plasteel/dark,/area/shuttle/escape)
"cj" = (/obj/machinery/door/airlock/hatch,/obj/effect/turf_decal/tile/green{dir = 8},/turf/open/floor/plasteel/dark,/area/shuttle/escape)
"ck" = (/obj/machinery/door/airlock/hatch,/obj/effect/turf_decal/tile/green,/turf/open/floor/plasteel/dark,/area/shuttle/escape)
"cl" = (/obj/structure/shuttle/engine/heater,/turf/open/floor/plating,/area/shuttle/escape)
"cm" = (/obj/structure/window/reinforced{dir = 8},/obj/effect/turf_decal/tile/green{dir = 1},/obj/effect/turf_decal/tile/green{dir = 8},/turf/open/floor/plasteel/dark,/area/shuttle/escape)
"cn" = (/obj/structure/window/reinforced{dir = 4},/obj/effect/turf_decal/tile/green,/obj/effect/turf_decal/tile/green{dir = 4},/turf/open/floor/plasteel/dark,/area/shuttle/escape)
"co" = (/obj/structure/shuttle/engine/propulsion,/turf/open/floor/plating,/area/shuttle/escape)
"cp" = (/obj/structure/window/reinforced,/obj/structure/window/reinforced{dir = 8},/obj/effect/turf_decal/tile/green{dir = 1},/obj/effect/turf_decal/tile/green{dir = 8},/turf/open/floor/plasteel/dark,/area/shuttle/escape)
"cq" = (/obj/structure/window/reinforced,/obj/structure/window/reinforced{dir = 4},/obj/effect/turf_decal/tile/green,/obj/effect/turf_decal/tile/green{dir = 4},/turf/open/floor/plasteel/dark,/area/shuttle/escape)
"cr" = (/obj/machinery/porta_turret/centcom_shuttle{dir = 5},/turf/closed/wall/mineral/plastitanium/interior,/area/shuttle/escape)
"cs" = (/turf/closed/wall/mineral/plastitanium/interior,/area/shuttle/escape)
"cz" = (/obj/machinery/button/door{id = "shuttleshutters"; name = "Bridge Blast Shutters"; pixel_y = -26; req_access_txt = "19"},/obj/machinery/light,/obj/effect/turf_decal/tile/blue,/obj/effect/turf_decal/tile/blue{dir = 8},/turf/open/floor/plasteel/dark,/area/shuttle/escape)
"ei" = (/obj/machinery/porta_turret/centcom_shuttle{dir = 10},/turf/closed/wall/mineral/plastitanium/interior,/area/shuttle/escape)
"en" = (/obj/machinery/porta_turret/centcom_shuttle{dir = 6},/turf/closed/wall/mineral/plastitanium/interior,/area/shuttle/escape)
"eB" = (/obj/machinery/flasher{id = "shuttleflash"; pixel_x = 24},/obj/machinery/light{dir = 4},/obj/effect/turf_decal/tile/green,/obj/effect/turf_decal/tile/green{dir = 4},/turf/open/floor/plasteel/dark,/area/shuttle/escape)
"eC" = (/obj/machinery/light{dir = 4},/obj/effect/turf_decal/tile/purple,/obj/effect/turf_decal/tile/purple{dir = 4},/turf/open/floor/plasteel/dark,/area/shuttle/escape)
"eD" = (/obj/machinery/light{dir = 8},/turf/open/floor/mineral/plastitanium/red,/area/shuttle/escape)
"eE" = (/obj/machinery/light{dir = 1},/obj/effect/turf_decal/tile/green{dir = 1},/obj/effect/turf_decal/tile/green{dir = 4},/turf/open/floor/plasteel/dark,/area/shuttle/escape)
"eF" = (/obj/machinery/light{dir = 8},/obj/effect/turf_decal/tile/green{dir = 1},/obj/effect/turf_decal/tile/green{dir = 8},/turf/open/floor/plasteel/dark,/area/shuttle/escape)
"eH" = (/obj/machinery/light,/obj/effect/turf_decal/tile/green,/obj/effect/turf_decal/tile/green{dir = 8},/turf/open/floor/plasteel/dark,/area/shuttle/escape)
"eN" = (/obj/machinery/light{dir = 4},/obj/effect/turf_decal/tile/green,/obj/effect/turf_decal/tile/green{dir = 4},/turf/open/floor/plasteel/dark,/area/shuttle/escape)
"eO" = (/obj/machinery/status_display/evac,/turf/closed/wall/mineral/plastitanium/nodiagonal,/area/shuttle/escape)
"eP" = (/turf/closed/wall/mineral/plastitanium/nodiagonal,/area/shuttle/escape)

(1,1,1) = {"
aaabacacacacacacabcradadadadadadad
csaeafagahaiajakalcsadadaabJbJcrad
acamanaoaoaoaoapaqacadcsarasatarcs
acauavawaxayczazaAacadcsaBaCaDaEcs
cscscsaraFaGarcscscsadbJaHaCaCaIbJ
adcsanaJaKaLaMapcsadadcsaNbJbJaOcs
aaaraParaQaQaraRarcradbJaSaTaUeCcs
bJaWaWcsbeeBcsbabbcsadbJaSaCaCaVbJ
bJaWbdbJbeaZbJbabfaRadbJbgbhaCbibJ
cseDbdbJbeaZbJbjbkcsadcsblbhaCbmbJ
bJaWbnbJbeaZeOcscsarcseObpaCaCbibJ
bJaWbdbJbebqbrbreEbrbsbtbubvaCbmcs
aXaWbdcseFbybzbzbzbzbsbAbAbBbCarcs
csbDabePbeaZeOcscsarcsbobJbJbJcsad
aYbFbreEbGaZcsbHbIbJadadadadadadad
bJbKaCaCaCbqbLbGaZbJadadadadadadad
bJbMbNeHbObybPeHbQbJadadadadadadad
cscscsarbRbSarcscscsadadadadadadad
adadcsbTbGbqbUcsadadadaacsbJbJcscr
aabJcsbobRbSbocsbJcradcsbVbrbrbWcs
aXbFbreEbGbqeEbrbWbJadcsbebXbYaZbJ
bJbebZbZaCaCbZbZaZePbJePbebXbYaZbJ
aXbecacaaCaCcacabqbrcbeEbGbXbYeNab
cseFaCaCaCaCaCaCaCaCaCaCaCaCaCaZbJ
bJbebZbZbZbZbZbZbybzcceHbObXbYeNab
csbecacacacacacaaZePbJePbebXbYaZbJ
bJcdbzeHbObyeHbzcebJadcsbebXbYaZbJ
eibJcsabbRbSabcsbJenadcscdbzbzcecs
adadcschbGbqcicsadadadcscsbJbJcscs
adcscsarcjckarcscsadadadadadadadad
aaarclclcmcnclclarcradadadadadadad
arcocococpcqcococoaradadadadadadad
"}
