"a" = (/obj/machinery/computer/emergency_shuttle{dir = 8},/turf/open/floor/mineral/titanium,/area/shuttle/escape/backup)
"b" = (/obj/machinery/door/airlock/titanium,/obj/docking_port/mobile/emergency/backup,/obj/structure/fans/tiny,/turf/open/floor/plating,/area/shuttle/escape/backup)
"f" = (/obj/structure/table/wood,/obj/item/book/manual/random,/turf/open/floor/mineral/titanium,/area/shuttle/escape/backup)
"g" = (/turf/open/floor/mineral/titanium,/area/shuttle/escape/backup)
"m" = (/turf/closed/wall/mineral/titanium,/area/shuttle/escape/backup)
"p" = (/turf/open/floor/mineral/plastitanium/red,/area/shuttle/escape/backup)
"q" = (/obj/machinery/status_display/evac,/turf/closed/wall/mineral/titanium,/area/shuttle/escape/backup)
"u" = (/obj/structure/chair/office/light{dir = 4},/turf/open/floor/mineral/titanium,/area/shuttle/escape/backup)
"x" = (/obj/machinery/light{dir = 8},/turf/open/floor/mineral/titanium,/area/shuttle/escape/backup)
"F" = (/obj/structure/table/wood,/obj/item/paper/fluff/stations/centcom/broken_evac,/turf/open/floor/mineral/titanium,/area/shuttle/escape/backup)
"P" = (/obj/machinery/light{dir = 4},/turf/open/floor/mineral/titanium,/area/shuttle/escape/backup)

(1,1,1) = {"
mqmmmmqm
mggppgam
bggppuFm
mggppgfm
mxgppgPm
mggggggm
mggppggm
mqmmmmqm
"}
