"a" = (/turf/template_noop,/area/template_noop)
"b" = (/obj/structure/shuttle/engine/propulsion{dir = 4},/turf/closed/wall/mineral/titanium,/area/shuttle/transport)
"c" = (/turf/closed/wall/mineral/titanium,/area/shuttle/transport)
"d" = (/obj/structure/window/shuttle,/obj/structure/grille,/turf/open/floor/plating,/area/shuttle/transport)
"e" = (/obj/effect/spawner/structure/window/shuttle,/turf/open/floor/plating,/area/shuttle/transport)
"f" = (/obj/machinery/door/airlock/titanium,/obj/structure/fans/tiny,/turf/open/floor/mineral/titanium/blue,/area/shuttle/transport)
"g" = (/turf/closed/wall/mineral/titanium/interior,/area/shuttle/transport)
"h" = (/obj/structure/chair/comfy/shuttle{dir = 4},/turf/open/floor/mineral/titanium/blue,/area/shuttle/transport)
"i" = (/obj/machinery/computer/shuttle/ferry/request{dir = 8},/turf/open/floor/mineral/titanium/blue,/area/shuttle/transport)
"j" = (/obj/structure/chair/comfy/shuttle,/turf/open/floor/mineral/titanium/blue,/area/shuttle/transport)
"k" = (/obj/machinery/door/airlock/titanium,/obj/docking_port/mobile{dir = 8; dwidth = 2; height = 12; id = "ferry"; name = "ferry shuttle"; port_direction = 2; width = 5},/obj/structure/fans/tiny,/turf/open/floor/mineral/titanium/blue,/area/shuttle/transport)
"l" = (/turf/open/floor/mineral/titanium/blue,/area/shuttle/transport)
"p" = (/obj/structure/closet/crate,/turf/open/floor/mineral/titanium/blue,/area/shuttle/transport)
"q" = (/obj/structure/chair/comfy/shuttle{dir = 1},/turf/open/floor/mineral/titanium/blue,/area/shuttle/transport)

(1,1,1) = {"
abccdccceccc
bghijjjjjjjd
fllllllllllk
bgppqqqqqqqd
abccdccceccc
"}
