//MAP CONVERTED BY dmm2tgm.py THIS HEADER COMMENT PREVENTS RECONVERSION, DO NOT REMOVE
"bx" = (
/turf/closed/wall/mineral/titanium/custom/window/ferry{
	dir = 1;
	icon_state = "ferry41"
	},
/area/shuttle/transport)
"bF" = (
/turf/closed/wall/mineral/titanium/custom/ferry{
	dir = 1;
	icon_state = "ferry17"
	},
/area/shuttle/transport)
"cB" = (
/turf/closed/wall/mineral/titanium/custom/window/ferry{
	dir = 1;
	icon_state = "ferry2"
	},
/area/shuttle/transport)
"fd" = (
/turf/closed/wall/mineral/titanium/custom/window/ferry{
	dir = 1;
	icon_state = "ferry29"
	},
/area/shuttle/transport)
"gv" = (
/obj/effect/turf_decal/loading_area/white{
	dir = 4;
	icon_state = "loadingarea_white_flip"
	},
/turf/open/floor/plasteel/dark{
	dir = 4;
	icon_state = "darkfull_plate"
	},
/area/shuttle/transport)
"hh" = (
/turf/closed/wall/mineral/titanium/custom/ferry{
	dir = 1;
	icon_state = "ferry37"
	},
/area/shuttle/transport)
"hF" = (
/obj/structure/chair/comfy/shuttle{
	dir = 4
	},
/obj/effect/turf_decal/loading_area{
	icon_state = "drain";
	name = "drain"
	},
/obj/effect/turf_decal/loading_area{
	dir = 1;
	icon_state = "drain";
	name = "drain"
	},
/obj/structure/window/reinforced/survival_pod,
/turf/open/floor/plasteel{
	dir = 8;
	icon_plating = "floor";
	icon_state = "floor_whole_alt"
	},
/area/shuttle/transport)
"hP" = (
/turf/closed/wall/mineral/titanium/custom/ferry{
	dir = 1;
	icon_state = "ferry32"
	},
/area/shuttle/transport)
"iS" = (
/turf/closed/wall/mineral/titanium/custom/ferry{
	dir = 1;
	icon_state = "ferry28"
	},
/area/shuttle/transport)
"jH" = (
/turf/closed/wall/mineral/titanium/custom/window/ferry{
	dir = 1;
	icon_state = "ferry3"
	},
/area/shuttle/transport)
"jI" = (
/turf/closed/wall/mineral/titanium/custom/ferry{
	dir = 1;
	icon_state = "ferry19"
	},
/area/shuttle/transport)
"kh" = (
/obj/structure/chair/comfy/shuttle{
	dir = 8
	},
/obj/effect/turf_decal/loading_area{
	color = "#55391A";
	dir = 5;
	icon_state = "siding_wood_line";
	name = "wood"
	},
/turf/open/floor/wood{
	icon_state = "wood_parquet";
	name = "parquet"
	},
/area/shuttle/transport)
"kD" = (
/obj/structure/chair/comfy/shuttle{
	dir = 8
	},
/obj/structure/window/reinforced/survival_pod{
	dir = 4
	},
/obj/effect/turf_decal/loading_area{
	color = "#55391A";
	dir = 5;
	icon_state = "siding_wood_line";
	name = "wood"
	},
/turf/open/floor/wood{
	icon_state = "wood_parquet";
	name = "parquet"
	},
/area/shuttle/transport)
"mw" = (
/turf/closed/wall/mineral/titanium/custom/window/ferry{
	dir = 1;
	icon_state = "ferry33"
	},
/area/shuttle/transport)
"mA" = (
/turf/closed/wall/mineral/titanium/custom/window/ferry{
	dir = 1;
	icon_state = "ferry34"
	},
/area/shuttle/transport)
"oc" = (
/turf/closed/wall/mineral/titanium/custom/ferry{
	dir = 1;
	icon_state = "ferry7"
	},
/area/shuttle/transport)
"of" = (
/turf/closed/wall/mineral/titanium/custom/window/ferry{
	dir = 1;
	icon_state = "ferry1"
	},
/area/shuttle/transport)
"oN" = (
/turf/template_noop,
/area/template_noop)
"oZ" = (
/turf/closed/wall/mineral/titanium/custom/ferry{
	dir = 1;
	icon_state = "ferry24"
	},
/area/shuttle/transport)
"pc" = (
/turf/closed/wall/mineral/titanium/custom/window/ferry{
	dir = 1;
	icon_state = "ferry36"
	},
/area/shuttle/transport)
"qx" = (
/turf/closed/wall/mineral/titanium/custom/ferry{
	dir = 1;
	icon_state = "ferry8"
	},
/area/shuttle/transport)
"qC" = (
/turf/closed/wall/mineral/titanium/custom/ferry{
	dir = 1;
	icon_state = "ferry22"
	},
/area/shuttle/transport)
"qE" = (
/turf/closed/wall/mineral/titanium/custom/window/ferry{
	dir = 1;
	icon_state = "ferry35"
	},
/area/shuttle/transport)
"qF" = (
/turf/closed/wall/mineral/titanium/custom/ferry{
	dir = 1;
	icon_state = "ferry20"
	},
/area/shuttle/transport)
"ry" = (
/obj/machinery/computer/shuttle/ferry/request{
	dir = 8
	},
/obj/effect/turf_decal/loading_area{
	icon_state = "drain";
	name = "drain"
	},
/obj/effect/turf_decal/loading_area{
	dir = 1;
	icon_state = "drain";
	name = "drain"
	},
/obj/effect/turf_decal/loading_area{
	dir = 4;
	icon_state = "drain";
	name = "drain"
	},
/obj/effect/turf_decal/loading_area{
	dir = 8;
	icon_state = "drain_corner";
	name = "drain"
	},
/obj/structure/window/reinforced/survival_pod,
/turf/open/floor/plasteel{
	dir = 8;
	icon_plating = "floor";
	icon_state = "floor_whole_alt"
	},
/area/shuttle/transport)
"uw" = (
/turf/closed/wall/mineral/titanium/custom/window/ferry{
	dir = 1;
	icon_state = "ferry21"
	},
/area/shuttle/transport)
"vp" = (
/turf/closed/wall/mineral/titanium/custom/ferry{
	dir = 1;
	icon_state = "ferry23"
	},
/area/shuttle/transport)
"vy" = (
/turf/closed/wall/mineral/titanium/custom/ferry{
	dir = 1;
	icon_state = "ferry25"
	},
/area/shuttle/transport)
"wR" = (
/obj/machinery/door/airlock/shuttle{
	name = "ferry airlock";
	req_access_txt = "101"
	},
/obj/structure/fans/tiny,
/obj/docking_port/mobile{
	dir = 8;
	dwidth = 3;
	height = 13;
	id = "ferry";
	name = "ferry shuttle";
	preferred_direction = 8;
	width = 7
	},
/obj/effect/turf_decal/delivery/white,
/turf/open/floor/plasteel/dark{
	icon_state = "darkfull_whole_alt"
	},
/area/shuttle/transport)
"xZ" = (
/turf/closed/wall/mineral/titanium/custom/ferry{
	dir = 1;
	icon_state = "ferry13"
	},
/area/shuttle/transport)
"yR" = (
/turf/closed/wall/mineral/titanium/custom/ferry{
	dir = 1;
	icon_state = "ferry14"
	},
/area/shuttle/transport)
"zV" = (
/obj/structure/flora/ausbushes/ywflowers,
/obj/structure/flora/ausbushes/palebush,
/obj/structure/window/reinforced/fulltile,
/turf/open/floor/grass,
/area/shuttle/transport)
"Ax" = (
/turf/closed/wall/mineral/titanium/custom/ferry{
	dir = 1;
	icon_state = "ferry15"
	},
/area/shuttle/transport)
"AD" = (
/turf/closed/wall/mineral/titanium/custom/ferry{
	dir = 1;
	icon_state = "ferry40"
	},
/area/shuttle/transport)
"AS" = (
/obj/machinery/door/airlock/shuttle{
	name = "ferry storage";
	req_access_txt = "101"
	},
/obj/effect/turf_decal/delivery/white,
/turf/open/floor/plasteel/dark{
	icon_state = "darkfull_whole_alt"
	},
/area/shuttle/transport)
"CX" = (
/obj/structure/shuttle/engine/heater{
	dir = 8
	},
/obj/structure/window/reinforced/survival_pod{
	dir = 1
	},
/obj/structure/window/reinforced/survival_pod,
/obj/structure/window/reinforced/survival_pod{
	dir = 4
	},
/obj/structure/flora/crystal/medium/growth{
	icon_state = "crystalgrowth2"
	},
/turf/open/floor/pod/dark,
/area/shuttle/transport)
"Fq" = (
/obj/effect/turf_decal/loading_area{
	color = "#55391A";
	dir = 1;
	icon_state = "siding_wood_line";
	name = "wood"
	},
/obj/machinery/light{
	pixel_y = -1
	},
/turf/open/floor/wood{
	icon_state = "wood_parquet";
	name = "parquet"
	},
/area/shuttle/transport)
"Fr" = (
/turf/closed/wall/mineral/titanium/custom/ferry{
	dir = 1;
	icon_state = "ferry16"
	},
/area/shuttle/transport)
"GK" = (
/turf/closed/wall/mineral/titanium/custom/window/ferry{
	dir = 1;
	icon_state = "ferry30"
	},
/area/shuttle/transport)
"GN" = (
/turf/closed/wall/mineral/titanium/custom/window/ferry{
	dir = 1;
	icon_state = "ferry31"
	},
/area/shuttle/transport)
"IB" = (
/turf/closed/wall/mineral/titanium/custom/ferry{
	dir = 1;
	icon_state = "ferry12"
	},
/area/shuttle/transport)
"IR" = (
/obj/effect/turf_decal/bot,
/obj/structure/closet/crate,
/obj/item/storage/toolbox/mechanical,
/obj/item/toy/plush/lizardplushie/arctaisia,
/turf/open/floor/plasteel/dark{
	icon_state = "darkfull_whole_alt"
	},
/area/shuttle/transport)
"LT" = (
/obj/structure/chair/comfy/shuttle{
	dir = 4
	},
/obj/effect/turf_decal/loading_area{
	color = "#55391A";
	dir = 1;
	icon_state = "siding_wood_line";
	name = "wood"
	},
/turf/open/floor/wood{
	icon_state = "wood_parquet";
	name = "parquet"
	},
/area/shuttle/transport)
"Mu" = (
/obj/structure/chair/comfy/shuttle{
	dir = 4
	},
/obj/structure/window/reinforced/survival_pod{
	dir = 8
	},
/obj/effect/turf_decal/loading_area{
	color = "#55391A";
	dir = 9;
	icon_state = "siding_wood_line";
	name = "wood"
	},
/turf/open/floor/wood{
	icon_state = "wood_parquet";
	name = "parquet"
	},
/area/shuttle/transport)
"MI" = (
/obj/effect/turf_decal/loading_area{
	dir = 8;
	icon_state = "trim";
	name = "trim"
	},
/obj/machinery/light{
	dir = 1
	},
/turf/open/floor/plasteel/dark{
	dir = 8;
	icon_state = "darkfull_plate"
	},
/area/shuttle/transport)
"MY" = (
/turf/closed/wall/mineral/titanium/custom/ferry{
	dir = 1;
	icon_state = "ferry11"
	},
/area/shuttle/transport)
"Na" = (
/turf/closed/wall/mineral/titanium/custom/ferry{
	dir = 1;
	icon_state = "ferry5"
	},
/area/shuttle/transport)
"OB" = (
/turf/open/floor/plasteel/dark{
	icon_state = "darkfull_trim"
	},
/area/shuttle/transport)
"Qx" = (
/turf/closed/wall/mineral/titanium/custom/window/ferry{
	dir = 1;
	icon_state = "ferry4"
	},
/area/shuttle/transport)
"Rt" = (
/turf/closed/wall/mineral/titanium/custom/ferry{
	dir = 1;
	icon_state = "ferry38"
	},
/area/shuttle/transport)
"Sg" = (
/obj/effect/turf_decal/loading_area{
	dir = 8;
	icon_state = "drain";
	name = "drain"
	},
/obj/effect/turf_decal/loading_area{
	dir = 1;
	icon_state = "drain";
	name = "drain"
	},
/obj/effect/turf_decal/loading_area{
	dir = 1;
	icon_state = "half_stairs";
	name = "steps"
	},
/obj/effect/turf_decal/loading_area{
	dir = 4;
	icon_state = "drain_corner";
	name = "drain"
	},
/obj/machinery/light{
	dir = 1
	},
/obj/effect/turf_decal/loading_area{
	dir = 1;
	icon_state = "steel_decals_central6_corner";
	name = "maintenance hatch"
	},
/turf/open/floor/plasteel{
	dir = 1;
	icon_state = "floor_plate"
	},
/area/shuttle/transport)
"SB" = (
/turf/closed/wall/mineral/titanium/custom/ferry{
	dir = 1;
	icon_state = "ferry26"
	},
/area/shuttle/transport)
"Tb" = (
/turf/closed/wall/mineral/titanium/custom/window/ferry{
	dir = 1;
	icon_state = "ferry0"
	},
/area/shuttle/transport)
"Tr" = (
/obj/effect/turf_decal/loading_area{
	dir = 8;
	icon_state = "trim";
	name = "trim"
	},
/obj/machinery/light{
	pixel_y = -1
	},
/turf/open/floor/plasteel/dark{
	dir = 8;
	icon_state = "darkfull_plate"
	},
/area/shuttle/transport)
"TT" = (
/turf/closed/wall/mineral/titanium/custom/ferry{
	dir = 1;
	icon_state = "ferry10"
	},
/area/shuttle/transport)
"Uu" = (
/obj/effect/turf_decal/loading_area{
	dir = 8;
	icon_state = "trim";
	name = "trim"
	},
/turf/open/floor/plasteel/dark{
	dir = 8;
	icon_state = "darkfull_plate"
	},
/area/shuttle/transport)
"UV" = (
/turf/closed/wall/mineral/titanium/custom/ferry{
	dir = 1;
	icon_state = "ferry9"
	},
/area/shuttle/transport)
"Vq" = (
/turf/closed/wall/mineral/titanium/custom/ferry{
	dir = 1;
	icon_state = "ferry18"
	},
/area/shuttle/transport)
"VV" = (
/obj/machinery/computer{
	dir = 4
	},
/turf/open/floor/plasteel/dark{
	dir = 4;
	icon_state = "darkfull_whole"
	},
/area/shuttle/transport)
"WS" = (
/turf/closed/wall/mineral/titanium/custom/ferry{
	dir = 1;
	icon_state = "ferry27"
	},
/area/shuttle/transport)
"Yi" = (
/turf/closed/wall/mineral/titanium/custom/ferry{
	dir = 1;
	icon_state = "ferry6"
	},
/area/shuttle/transport)
"Zj" = (
/obj/item/radio/intercom{
	freerange = 1;
	listening = 0;
	name = "Custom Channel";
	pixel_y = 19
	},
/turf/open/floor/plasteel/dark{
	icon_state = "darkfull_trim"
	},
/area/shuttle/transport)
"ZJ" = (
/turf/closed/wall/mineral/titanium/custom/ferry{
	dir = 1;
	icon_state = "ferry39"
	},
/area/shuttle/transport)

(1,1,1) = {"
oN
oN
oN
oN
oN
oN
oN
"}
(2,1,1) = {"
oN
hh
WS
SB
jI
Ax
oN
"}
(3,1,1) = {"
bx
Rt
VV
CX
IR
Fr
Qx
"}
(4,1,1) = {"
mw
ZJ
MI
Uu
Tr
bF
Tb
"}
(5,1,1) = {"
mA
AD
qF
AS
xZ
Vq
of
"}
(6,1,1) = {"
qE
hP
Sg
OB
LT
IB
cB
"}
(7,1,1) = {"
pc
iS
hF
OB
Fq
Na
jH
"}
(8,1,1) = {"
oN
fd
ry
OB
kD
Yi
oN
"}
(9,1,1) = {"
oN
GK
uw
OB
Mu
oc
oN
"}
(10,1,1) = {"
oN
GN
qC
OB
Fq
qx
oN
"}
(11,1,1) = {"
oN
oN
vp
Zj
kh
UV
oN
"}
(12,1,1) = {"
oN
oN
oZ
gv
zV
TT
oN
"}
(13,1,1) = {"
oN
oN
vy
wR
yR
MY
oN
"}
