"a" = (/turf/open/space/basic,/area/space)
"b" = (/turf/closed/wall/mineral/titanium/survival/pod,/area/survivalpod)
"c" = (/obj/structure/sign/mining/survival{dir = 1},/turf/closed/wall/mineral/titanium/survival/pod,/area/survivalpod)
"d" = (/obj/structure/fans,/turf/open/floor/pod,/area/survivalpod)
"e" = (/obj/machinery/smartfridge/survival_pod,/turf/open/floor/pod,/area/survivalpod)
"f" = (/obj/item/gps/computer,/turf/open/floor/pod,/area/survivalpod)
"g" = (/obj/structure/sign/mining/survival{dir = 8},/turf/closed/wall/mineral/titanium/survival/pod,/area/survivalpod)
"h" = (/obj/machinery/sleeper/survival_pod,/turf/open/floor/pod,/area/survivalpod)
"i" = (/turf/open/floor/pod,/area/survivalpod)
"j" = (/obj/structure/bed/pod,/obj/item/bedsheet/black,/turf/open/floor/pod,/area/survivalpod)
"k" = (/obj/structure/sign/mining/survival{dir = 4},/turf/closed/wall/mineral/titanium/survival/pod,/area/survivalpod)
"l" = (/obj/structure/table/survival_pod,/turf/open/floor/pod,/area/survivalpod)
"m" = (/obj/structure/tubes,/obj/structure/chair/comfy/black{dir = 8},/turf/open/floor/pod,/area/survivalpod)
"n" = (/obj/structure/sign/mining/survival,/turf/closed/wall/mineral/titanium/survival/pod,/area/survivalpod)
"o" = (/obj/structure/fans/tiny,/obj/machinery/door/airlock/survival_pod/glass,/turf/open/floor/pod,/area/survivalpod)
"p" = (/obj/structure/sign/mining,/turf/closed/wall/mineral/titanium/survival/pod,/area/survivalpod)

(1,1,1) = {"
bbcbb
bdefb
ghijk
blimb
bnopb
"}

(1,1,2) = {"
aaaaa
aaaaa
aaaaa
aaaaa
aaaaa
"}

(1,1,3) = {"
aaaaa
aaaaa
aaaaa
aaaaa
aaaaa
"}

(1,1,4) = {"
aaaaa
aaaaa
aaaaa
aaaaa
aaaaa
"}

(1,1,5) = {"
aaaaa
aaaaa
aaaaa
aaaaa
aaaaa
"}
