"a" = (/turf/closed/wall/mineral/titanium/survival/pod,/area/survivalpod)
"b" = (/obj/structure/sign/mining/survival{dir = 1},/turf/closed/wall/mineral/titanium/survival/pod,/area/survivalpod)
"c" = (/obj/structure/sign/mining/survival{dir = 8},/turf/closed/wall/mineral/titanium/survival/pod,/area/survivalpod)
"d" = (/obj/structure/fans,/turf/open/floor/pod,/area/survivalpod)
"e" = (/obj/machinery/smartfridge/survival_pod,/turf/open/floor/pod,/area/survivalpod)
"f" = (/obj/item/gps/computer,/turf/open/floor/pod,/area/survivalpod)
"g" = (/obj/structure/ore_box,/obj/structure/window/reinforced/survival_pod{dir = 8; layer = 3},/turf/open/floor/pod,/area/survivalpod)
"h" = (/obj/effect/spawner/lootdrop/mre,/obj/effect/spawner/lootdrop/mre,/obj/effect/spawner/lootdrop/mre,/obj/effect/spawner/lootdrop/mre,/obj/effect/spawner/lootdrop/mre,/obj/effect/spawner/lootdrop/mre,/obj/structure/rack,/turf/open/floor/pod,/area/survivalpod)
"i" = (/obj/structure/sign/mining/survival{dir = 4},/turf/closed/wall/mineral/titanium/survival/pod,/area/survivalpod)
"j" = (/obj/machinery/sleeper/survival_pod,/turf/open/floor/pod,/area/survivalpod)
"k" = (/turf/open/floor/pod,/area/survivalpod)
"l" = (/obj/structure/bed/pod,/obj/item/bedsheet/black,/turf/open/floor/pod,/area/survivalpod)
"m" = (/obj/structure/window/reinforced/survival_pod{dir = 8; layer = 3},/turf/open/floor/pod,/area/survivalpod)
"n" = (/obj/structure/table/survival_pod,/obj/item/storage/firstaid/regular,/turf/open/floor/pod,/area/survivalpod)
"o" = (/obj/structure/tubes,/turf/open/floor/pod,/area/survivalpod)
"p" = (/obj/structure/window/reinforced/survival_pod{dir = 8},/turf/open/floor/pod,/area/survivalpod)
"q" = (/obj/machinery/light{dir = 4; light_color = "#DDFFD3"},/turf/open/floor/pod,/area/survivalpod)
"r" = (/obj/structure/window/reinforced/survival_pod{dir = 1},/obj/machinery/shower{layer = 2},/obj/structure/curtain{alpha = 240; color = "#454545"; icon_state = "closed"; layer = 5.1; open = 0},/turf/open/floor/pod,/area/survivalpod)
"s" = (/obj/structure/window/reinforced/survival_pod{dir = 1},/obj/structure/window/reinforced/survival_pod{icon_state = "pwindow"; dir = 4},/obj/structure/toilet{layer = 2},/obj/structure/curtain{alpha = 240; color = "#454545"; icon_state = "closed"; layer = 5.1; open = 0},/turf/open/floor/pod,/area/survivalpod)
"t" = (/obj/machinery/door/window/survival_pod{icon_state = "windoor"; dir = 1},/turf/open/floor/pod,/area/survivalpod)
"u" = (/obj/structure/window/reinforced/survival_pod{density = 0; dir = 9},/turf/open/floor/pod,/area/survivalpod)
"v" = (/obj/structure/chair,/turf/open/floor/pod,/area/survivalpod)
"w" = (/obj/structure/sink/kitchen{icon_state = "sink_alt"; dir = 4; pixel_x = -13},/turf/open/floor/pod,/area/survivalpod)
"x" = (/obj/machinery/light,/obj/machinery/door/window/survival_pod{icon_state = "windoor"; dir = 4},/turf/open/floor/pod,/area/survivalpod)
"y" = (/obj/structure/table/reinforced,/turf/open/floor/pod,/area/survivalpod)
"z" = (/obj/structure/sign/mining/survival,/turf/closed/wall/mineral/titanium/survival/pod,/area/survivalpod)
"A" = (/obj/machinery/door/airlock/survival_pod/glass,/obj/structure/fans/tiny,/turf/open/floor/pod,/area/survivalpod)
"B" = (/obj/structure/sign/mining,/turf/closed/wall/mineral/titanium/survival/pod,/area/survivalpod)
"C" = (/obj/structure/fans/tiny,/obj/machinery/door/airlock/survival_pod/glass,/obj/structure/fans/tiny,/turf/open/floor/pod,/area/survivalpod)

(1,1,1) = {"
abababa
cdefghi
ajklmqa
cnkopkA
arstuva
cwxkkyi
azaCaBa
"}
